20
453 982 368 713 175 972 771 555 273 746 518 415 458 738 162 328 473 538 45 615
388 359 708 402 265 830 868 326 431 895 904 865 351 537 207 518 530 564 907 437
375 354 13 361 846 210 725 747 911 483 61 439 496 3 758 829 484 967 805 556
569 299 273 464 900 798 870 204 42 12 491 846 662 769 731 197 173 147 629 981
33 426 938 80 498 283 64 129 744 941 649 823 952 889 377 36 623 162 343 519
424 493 248 888 378 360 955 363 970 176 922 98 397 70 763 289 832 346 114 834
568 87 50 157 71 210 657 690 911 302 226 278 727 891 339 559 803 660 721 835
442 897 709 779 653 392 910 219 299 8 273 469 252 396 964 906 912 811 540 627
564 347 941 115 433 11 707 60 458 275 43 321 128 900 839 177 415 594 490 571
861 164 219 347 987 978 395 119 254 394 826 541 97 183 453 378 421 559 596 236
352 420 654 543 363 268 961 34 191 825 999 590 767 457 312 188 332 443 967 625
9 673 580 797 29 806 391 480 962 933 716 899 674 936 560 182 76 310 49 612
221 904 438 866 593 399 654 265 861 487 459 422 179 804 168 942 712 857 638 453
100 585 702 742 594 34 320 843 777 143 452 4 557 280 481 749 18 16 884 344
540 939 572 593 749 247 282 442 767 436 771 974 52 67 349 43 256 880 990 348
225 877 918 921 359 271 967 75 220 66 238 622 534 309 449 147 433 20 229 453
537 994 557 156 748 256 55 485 420 634 536 247 117 125 932 530 787 163 471 287
327 272 591 988 959 836 724 391 957 693 217 185 315 798 596 738 79 801 782 575
402 703 857 470 379 647 397 380 102 992 104 85 497 519 905 6 476 454 726 270
325 597 313 831 473 529 376 863 678 657 554 800 160 253 363 583 971 201 834 706
