20
975 225 112 76 559 161 154 510 419 18 994 193 482 157 957 791 613 152 163 915
253 209 168 663 102 217 212 478 461 65 388 161 706 995 3 54 52 575 171 148
325 180 986 834 690 493 872 863 652 469 17 859 360 19 108 208 516 585 139 796
137 660 272 599 340 615 567 468 79 502 860 647 76 29 95 722 501 387 77 104
882 712 975 55 659 592 688 337 284 909 168 58 156 804 283 526 948 79 126 397
717 955 82 30 317 507 47 994 968 934 571 873 72 527 546 342 881 881 784 588
771 249 737 489 456 79 963 487 389 669 189 592 919 291 235 912 643 338 429 895
405 184 911 316 834 655 233 261 451 113 978 179 881 246 114 446 190 418 40 77
109 960 155 752 969 267 867 239 415 598 832 208 790 950 530 961 654 379 185 858
116 796 923 728 61 587 960 663 449 457 717 638 880 168 419 725 90 786 492 12
479 17 662 803 573 422 460 902 87 600 617 979 341 749 718 437 841 39 609 633
922 390 651 87 198 34 74 792 493 870 963 242 3 394 315 637 315 406 381 377
157 762 169 790 423 658 299 817 182 403 492 560 731 414 800 986 12 272 259 362
451 141 888 93 571 613 56 219 441 868 673 563 648 831 961 865 805 166 39 344
116 415 545 52 672 806 906 157 797 14 583 525 407 600 840 179 801 153 115 850
794 707 794 892 461 424 603 430 89 567 425 998 89 728 331 827 719 804 844 487
804 739 259 177 140 507 869 498 125 546 132 927 422 533 244 326 787 654 621 280
559 615 96 248 562 979 432 784 963 491 283 936 941 817 635 764 732 798 936 723
74 958 717 446 215 252 465 594 12 385 228 142 609 421 805 323 615 539 99 961
383 248 888 433 763 937 47 812 15 354 679 233 622 412 330 808 842 720 833 986
