20
96 202 246 246 900 460 657 401 606 855 321 865 299 84 736 88 121 611 766 145
54 77 343 787 169 818 382 566 834 769 424 921 842 559 64 447 393 850 576 198
106 709 381 808 176 912 339 582 115 122 799 962 907 658 711 956 462 733 827 649
564 883 979 699 100 622 629 547 711 72 901 181 558 781 420 449 863 424 462 429
111 611 169 786 381 735 66 962 65 322 566 791 333 663 899 488 18 257 90 482
421 975 490 646 815 938 852 879 232 599 70 477 299 357 864 326 795 349 707 456
853 317 303 510 852 129 869 623 793 723 992 842 795 464 403 154 683 265 647 196
594 331 72 625 53 364 852 252 417 199 878 589 623 33 811 244 470 925 965 359
683 932 615 605 866 7 38 655 429 201 889 745 46 884 305 599 827 635 940 863
701 772 617 217 967 116 565 22 525 545 741 709 26 677 836 328 384 552 576 920
997 821 823 797 381 476 752 780 47 82 369 199 461 407 697 762 104 844 945 744
732 868 850 640 308 261 135 244 263 367 794 618 49 394 31 966 643 327 131 640
508 24 623 109 865 149 238 398 915 135 468 341 452 578 256 920 716 418 748 866
323 566 990 57 51 635 327 581 798 698 470 959 195 851 248 319 178 346 632 448
394 682 9 980 401 332 848 858 49 405 406 291 694 321 765 372 143 654 473 988
38 828 270 704 815 997 374 200 621 417 668 306 394 676 685 666 539 350 530 923
584 257 949 720 529 802 408 664 93 739 657 648 551 753 822 87 73 416 172 209
719 348 967 574 45 16 702 182 105 807 732 519 446 563 975 668 854 756 674 282
252 415 967 929 602 830 410 759 127 752 330 384 688 473 401 199 236 654 968 942
494 708 587 308 561 987 264 860 984 498 645 449 792 230 851 49 906 932 978 494
