20
680 330 267 281 217 740 446 567 785 208 99 990 564 374 125 200 585 473 912 743
308 239 68 106 747 251 571 273 850 371 422 161 224 721 254 833 950 814 644 871
555 348 818 529 158 963 355 219 868 109 233 733 418 694 397 178 801 186 425 44
888 649 538 95 223 714 936 162 55 986 10 671 356 538 615 282 566 929 307 932
735 451 931 518 692 546 213 749 444 106 578 481 989 89 988 183 551 799 483 913
640 814 646 351 262 511 185 225 140 230 424 465 730 135 1 837 962 989 935 969
234 950 693 969 493 371 529 860 782 5 926 803 744 209 438 834 156 11 452 952
192 243 648 273 819 964 941 71 93 607 320 2 802 790 191 663 160 601 380 231
603 641 577 705 77 735 65 90 404 771 944 672 697 70 137 869 333 687 677 14
722 15 186 632 275 860 990 675 554 704 976 541 175 104 613 456 776 835 403 820
458 282 207 545 379 588 135 26 78 499 876 735 1000 398 603 863 89 822 240 189
820 941 590 808 34 482 314 947 120 307 884 8 844 743 540 779 871 580 723 881
979 375 670 86 711 612 562 450 95 943 469 474 809 783 257 479 388 592 353 270
399 656 107 355 360 663 223 83 667 896 918 681 493 418 560 692 993 588 837 746
377 107 913 464 294 31 148 199 455 48 200 653 922 279 650 239 260 408 845 607
937 592 29 125 614 285 171 896 56 503 927 277 21 207 14 771 975 108 954 500
432 372 520 496 546 891 5 519 522 941 3 178 568 845 12 412 923 429 82 165
554 916 951 42 368 214 79 458 37 734 323 268 348 592 3 72 744 43 276 440
812 891 925 726 248 679 277 361 807 547 385 273 860 116 824 713 769 113 102 460
394 135 643 912 110 983 293 605 285 609 314 863 789 70 277 249 1 698 995 63
