20
970 478 969 497 983 22 520 382 979 65 244 821 58 672 420 849 235 13 199 892
252 290 606 132 817 514 30 573 653 726 30 429 719 146 782 102 910 59 589 805
731 796 302 327 960 922 753 220 425 393 724 711 511 751 90 520 659 882 63 133
85 358 72 346 419 648 571 553 716 780 545 169 638 653 889 519 715 185 154 232
233 716 367 315 201 29 729 582 947 754 480 627 843 224 145 539 985 662 215 104
355 3 939 830 673 141 508 113 415 375 1 395 463 588 952 951 650 115 869 506
76 608 539 596 771 179 21 760 998 11 585 373 434 260 33 9 14 26 559 891
147 592 205 322 924 467 465 829 217 110 289 588 307 38 441 26 609 606 486 640
753 995 319 204 357 318 837 339 819 331 628 562 974 613 325 78 625 745 433 318
393 728 79 865 835 466 61 343 71 795 474 165 131 518 469 229 621 729 7 250
384 181 606 950 463 149 873 243 341 256 772 776 658 678 491 498 296 60 160 459
620 199 186 290 154 732 393 324 424 814 139 189 653 546 623 180 826 925 100 686
913 523 648 427 784 309 51 402 67 852 911 663 548 492 948 122 371 655 195 242
725 234 547 429 77 749 319 469 82 250 970 112 457 879 726 41 115 494 296 405
526 186 535 629 875 537 858 899 88 506 74 644 821 135 567 730 276 384 718 170
808 801 10 617 326 603 3 864 234 321 991 684 430 528 580 471 353 630 966 565
924 163 514 340 984 420 412 831 601 262 754 470 495 762 369 216 62 56 549 345
370 567 581 162 431 200 935 301 270 26 393 471 688 904 747 750 350 902 740 478
288 309 240 334 519 776 485 952 732 346 193 535 252 722 375 309 680 252 208 13
437 865 524 127 734 450 399 36 410 130 974 890 998 33 418 242 640 871 154 236
