20
727 109 141 630 91 611 575 109 386 47 557 417 86 308 507 38 790 521 115 863
615 100 341 258 661 853 905 996 149 189 202 540 90 181 17 733 225 692 647 136
209 957 561 174 669 363 26 755 365 684 79 215 108 452 853 1000 998 450 570 12
622 867 276 327 809 868 284 10 713 693 19 874 132 496 199 378 289 233 978 171
512 5 498 193 314 126 997 610 564 469 463 528 164 839 65 320 675 486 191 533
256 695 514 677 829 269 539 189 478 429 239 866 647 221 515 416 808 939 393 434
600 950 174 421 126 898 829 372 33 644 149 38 721 787 417 256 361 480 711 868
541 388 919 426 906 675 616 236 893 894 910 416 719 353 834 497 321 910 696 784
797 830 235 187 590 308 849 301 35 135 224 915 627 185 304 502 657 707 45 699
247 356 580 134 854 459 400 462 481 110 8 26 868 901 715 233 908 171 750 16
278 509 597 454 222 94 422 322 373 182 586 251 635 885 164 822 912 391 689 306
574 429 462 289 616 687 582 521 123 144 323 690 602 463 863 877 368 14 902 264
715 45 667 335 381 84 663 376 654 944 756 141 773 639 130 357 48 976 35 805
470 693 112 338 411 908 759 153 222 231 514 327 950 7 174 568 403 821 930 693
363 819 417 420 361 841 664 987 860 156 140 45 659 429 494 772 297 521 3 167
119 81 389 941 206 261 386 531 293 409 526 818 969 986 560 111 658 455 393 458
977 721 174 312 457 764 143 307 622 203 737 640 765 267 446 806 706 435 24 188
778 532 986 757 209 324 276 743 257 534 210 407 636 40 544 408 116 242 52 16
591 10 670 642 981 90 13 17 259 22 936 46 574 817 597 936 436 656 169 989
353 271 669 295 606 825 959 629 513 229 263 291 158 546 700 467 811 445 237 756
