20
88 92 573 828 50 109 924 868 732 848 441 171 628 784 619 888 214 843 132 334
132 441 95 409 79 441 297 174 568 19 11 11 126 291 844 368 809 222 667 5
405 181 656 578 21 341 764 581 849 468 460 187 559 581 574 732 10 89 962 388
339 565 612 835 665 664 163 275 809 591 781 914 666 322 726 412 46 476 897 255
50 141 718 678 909 365 907 865 793 516 656 185 469 378 791 955 673 336 783 483
231 813 327 843 997 164 462 994 494 934 277 289 818 275 594 308 915 368 344 812
219 594 333 444 661 115 424 245 102 343 776 365 931 506 483 761 462 650 481 603
288 664 200 782 570 881 363 757 467 625 468 564 707 783 86 928 563 568 765 353
162 906 389 700 875 343 66 697 716 448 788 75 718 126 758 894 922 511 576 617
708 256 97 405 905 412 184 884 345 891 546 652 42 385 607 406 398 564 452 360
338 865 140 714 734 263 805 818 224 226 807 109 621 867 254 811 633 935 448 350
716 873 80 163 810 350 786 759 340 203 675 133 304 711 478 478 499 619 833 765
786 299 783 554 713 686 272 946 21 906 746 347 242 693 375 791 482 185 83 608
550 237 114 462 29 437 460 826 991 497 685 758 846 4 685 997 575 999 731 147
412 532 132 783 376 226 484 296 438 635 226 110 531 663 23 920 107 579 563 605
279 132 91 636 127 938 835 732 396 512 77 919 268 784 729 827 360 63 237 631
185 562 624 196 759 360 917 112 878 110 584 895 330 361 759 864 458 641 387 393
779 653 162 412 442 16 490 995 453 481 659 805 910 604 28 372 1 957 687 795
695 992 526 826 781 874 337 443 443 723 477 298 681 792 213 200 727 347 179 330
500 914 220 307 525 629 738 380 510 990 206 230 222 909 295 227 496 626 504 712
