20
82 294 65 231 86 254 784 953 185 652 343 267 941 336 954 989 375 841 862 439
985 709 145 716 666 925 985 853 271 915 349 224 316 965 496 82 333 830 751 940
217 77 771 125 596 703 951 590 80 397 173 726 391 167 602 170 263 249 288 319
812 802 777 396 406 515 789 639 516 612 173 171 484 523 809 426 795 823 257 573
548 504 593 483 148 198 105 11 825 219 479 258 188 655 33 569 187 434 570 816
281 218 555 6 245 186 370 803 546 72 508 702 133 177 983 811 485 804 280 392
172 910 309 981 985 817 77 438 631 171 599 460 137 771 445 725 174 573 283 57
358 1 322 365 475 214 39 642 646 574 251 458 539 474 618 993 348 679 732 386
827 9 696 843 947 689 776 55 543 188 508 337 732 563 711 362 613 453 537 472
292 917 928 974 181 410 651 168 989 358 594 879 305 223 970 478 483 526 431 921
207 254 743 878 89 964 625 41 527 332 758 669 630 125 101 783 949 566 206 517
751 495 729 675 966 655 878 499 764 696 773 950 735 480 864 647 225 231 190 880
877 233 75 30 603 17 423 274 887 208 65 872 943 365 416 855 106 151 200 950
187 54 732 817 584 844 351 939 962 233 956 277 723 516 806 775 396 41 868 916
702 771 836 866 809 130 437 449 380 999 412 59 689 85 33 480 25 436 514 664
176 362 449 635 861 80 475 224 420 956 413 836 986 64 720 86 351 640 79 670
943 684 554 226 260 649 372 803 382 21 252 978 906 193 140 689 688 698 205 19
280 196 444 369 787 384 996 626 491 246 300 696 450 564 983 70 394 153 337 961
787 385 846 845 558 290 478 475 175 668 727 960 63 315 859 923 367 842 635 255
184 387 843 507 443 23 53 324 607 511 640 686 526 406 487 198 281 166 558 859
