20
419 628 607 207 99 473 149 971 520 164 295 698 506 951 284 761 828 506 837 487
506 457 330 404 547 891 513 833 786 845 25 721 787 459 497 439 778 564 76 350
153 953 155 27 119 523 637 162 780 990 472 823 965 964 49 909 964 202 183 394
164 467 627 470 511 172 698 251 77 823 539 20 197 469 237 628 155 778 143 133
838 944 780 36 332 8 271 33 916 885 36 738 764 464 965 192 305 290 508 782
599 138 593 832 463 961 692 795 77 981 234 487 12 219 40 487 889 991 632 506
992 846 590 491 383 127 168 34 581 475 218 683 894 204 409 842 903 761 594 221
761 647 872 577 250 18 361 548 357 645 38 285 549 344 775 81 469 90 220 318
802 366 468 687 570 184 624 875 19 573 261 599 976 191 203 686 618 29 844 166
410 723 506 628 774 43 253 549 204 986 195 605 511 444 442 616 761 990 915 48
728 714 867 143 212 944 79 197 386 505 309 977 554 132 693 61 270 276 894 257
874 664 974 727 666 947 242 22 601 402 457 612 961 218 395 115 721 154 238 427
338 415 571 75 173 84 317 81 517 699 779 619 375 489 737 681 510 985 916 649
88 32 878 894 426 885 212 342 986 434 734 897 893 429 124 512 589 392 949 761
629 584 598 527 538 427 492 564 872 93 930 810 79 23 872 391 732 987 851 497
504 820 316 571 147 880 838 382 316 846 628 950 293 516 404 730 258 483 644 302
583 182 713 714 187 63 619 527 58 306 742 695 240 894 467 773 778 215 168 415
132 484 257 417 294 907 484 874 96 688 12 381 702 547 207 847 829 308 554 503
24 30 696 797 585 267 888 175 682 381 484 540 405 356 340 149 164 246 375 212
94 594 516 996 260 332 340 177 966 418 442 988 398 855 698 435 304 686 291 707
