20
713 332 858 118 142 265 788 290 718 688 276 859 246 472 378 697 15 672 666 863
915 270 613 849 225 932 764 461 489 897 428 838 475 729 218 299 736 858 506 517
732 894 10 689 951 455 224 985 657 547 962 491 849 338 891 352 313 555 299 260
701 336 21 85 444 185 581 459 673 769 666 657 845 626 310 819 284 224 985 358
373 238 799 772 736 477 658 978 639 545 978 981 63 800 108 353 580 854 568 672
356 148 568 345 895 586 637 434 418 732 813 800 537 596 179 291 323 851 242 160
586 305 672 973 349 530 932 341 992 110 717 100 728 664 481 119 109 947 671 551
159 103 591 258 205 835 139 633 738 241 505 522 122 101 856 521 49 855 394 788
325 684 603 156 278 999 525 737 709 682 146 748 30 152 983 683 615 687 600 6
51 296 410 711 407 220 955 352 290 471 873 596 733 126 230 380 858 481 888 841
135 92 760 527 903 598 761 633 936 452 369 897 974 466 946 824 122 972 848 165
327 140 334 333 769 595 375 145 622 796 608 286 794 627 282 897 28 868 909 313
698 992 385 664 887 633 939 596 977 346 644 818 883 905 642 82 296 908 247 928
83 219 406 196 737 659 201 687 721 94 909 778 79 296 8 586 18 742 951 914
332 22 841 110 134 757 113 704 493 570 964 421 756 937 497 672 333 64 259 770
529 774 103 736 690 903 512 662 498 551 693 30 113 541 209 649 130 103 808 334
930 75 961 644 997 289 822 204 20 850 688 470 673 940 438 728 301 415 781 297
740 360 205 949 759 428 568 151 928 715 248 485 671 785 67 151 791 869 308 687
557 803 896 489 609 856 674 132 489 912 726 642 134 226 836 173 653 56 332 422
233 319 299 4 248 913 459 365 294 673 594 848 146 859 550 567 632 164 213 870
