20
745 602 205 125 906 607 802 966 842 621 235 344 744 29 784 45 987 373 484 647
468 180 204 554 231 79 258 543 281 368 235 953 977 127 815 528 34 738 623 70
831 972 361 539 174 142 203 413 385 858 961 159 171 478 210 436 792 867 802 396
674 811 981 275 465 233 698 243 898 359 178 137 607 150 467 280 947 713 245 102
500 772 418 542 440 676 715 921 146 463 158 298 440 39 370 521 15 58 207 793
184 279 205 378 750 314 285 301 311 903 856 809 977 5 152 135 844 819 176 147
762 349 189 802 535 856 93 377 206 59 24 789 839 397 117 198 506 724 127 832
693 807 213 358 300 319 245 594 179 464 808 869 694 344 832 641 740 432 245 14
32 487 202 818 840 136 836 70 396 994 190 538 281 254 774 101 102 784 507 763
80 245 662 400 530 360 472 129 292 141 610 614 130 634 136 870 177 900 147 977
537 981 879 345 429 496 386 127 566 743 614 525 287 947 165 66 342 820 582 78
784 574 316 212 707 503 4 834 24 724 703 744 21 458 965 695 574 206 106 848
56 841 545 349 579 423 926 234 468 778 977 528 161 12 155 643 982 960 860 800
621 291 209 995 133 803 593 472 9 487 717 797 281 121 620 322 689 899 263 955
348 114 238 199 16 956 383 604 387 963 605 173 939 413 21 274 275 337 982 407
366 489 532 578 52 261 637 254 183 202 306 331 963 726 798 731 847 807 826 561
219 322 647 382 534 107 827 880 219 738 76 881 440 898 490 163 934 466 646 453
744 10 523 681 516 704 795 172 603 90 370 900 785 811 783 193 225 904 240 407
792 975 282 117 250 524 583 767 496 55 482 302 429 62 397 187 61 898 329 697
3 745 546 835 726 755 256 948 943 56 195 378 593 314 841 995 734 866 121 60
