20
365 844 608 161 555 722 78 835 304 194 733 868 193 288 220 131 997 6 525 243
91 987 825 198 50 513 994 612 288 881 637 896 829 217 737 537 228 220 7 84
563 581 404 628 186 645 321 683 595 31 226 103 606 87 528 115 885 118 368 612
126 852 490 828 327 132 297 785 24 412 541 543 293 985 815 776 317 621 470 475
879 909 516 550 652 939 129 104 214 740 750 5 871 198 893 1 945 799 938 874
92 390 850 300 665 461 348 331 430 653 713 917 81 659 279 669 927 992 539 409
574 545 566 340 555 816 854 778 888 839 81 573 62 186 499 508 86 440 202 701
693 160 225 473 136 694 960 822 858 987 930 567 102 47 936 162 462 188 865 954
42 977 67 212 702 247 24 287 543 498 149 929 651 762 529 870 72 150 907 570
289 136 276 408 237 513 34 849 920 153 951 916 11 963 825 688 476 295 44 574
695 770 307 493 125 614 390 346 346 783 883 783 338 171 591 407 933 465 732 823
831 594 11 648 633 266 631 6 430 314 787 153 403 867 138 825 999 463 731 732
439 599 119 14 862 132 154 261 991 53 255 271 550 483 989 533 429 812 854 337
217 524 74 597 628 805 394 146 737 938 706 820 361 906 413 62 867 338 778 726
301 939 645 268 666 406 806 181 712 523 956 737 87 245 19 459 607 679 586 768
123 78 808 902 704 127 809 769 60 131 928 788 394 489 355 342 713 85 223 698
255 574 396 945 529 632 545 976 799 669 221 513 406 962 742 831 213 381 811 346
861 174 697 187 415 421 961 984 355 237 984 402 463 111 455 613 118 836 40 824
51 732 669 356 295 234 270 355 481 618 532 220 142 350 532 627 740 153 504 178
779 80 702 805 495 381 202 343 214 545 934 423 48 847 917 105 960 970 646 950
