20
524 7 697 192 81 471 821 66 405 855 705 814 394 279 659 964 75 281 499 960
994 592 889 113 734 877 717 56 316 880 937 49 99 202 271 222 337 627 533 723
807 323 457 25 926 34 110 411 145 565 306 923 964 664 440 938 761 730 349 982
177 571 387 543 920 436 503 599 244 518 844 916 523 827 884 862 685 336 222 865
126 891 370 639 971 589 734 200 483 193 559 329 921 47 998 794 240 632 399 826
423 811 541 439 870 171 607 187 446 818 964 192 763 927 333 29 440 411 839 982
303 510 437 731 10 183 190 442 1 576 971 78 861 897 117 456 395 104 708 409
696 880 972 654 678 929 172 154 122 160 263 441 807 138 60 349 227 443 448 386
995 119 749 751 682 888 800 543 555 774 585 628 488 882 513 155 685 77 737 546
335 247 253 305 119 889 564 507 567 481 687 960 4 418 181 277 848 763 7 745
776 398 290 419 556 925 861 970 534 365 330 75 870 813 824 59 984 346 601 126
74 465 270 405 27 705 443 942 724 441 286 121 237 967 889 330 289 655 521 207
78 629 933 566 412 52 429 837 319 356 479 888 357 145 553 821 418 127 863 511
79 277 315 838 254 959 482 330 331 76 299 825 826 100 158 864 887 182 508 173
842 558 460 146 943 393 691 823 910 220 541 369 439 653 443 975 879 868 888 674
48 432 595 26 822 709 784 897 30 312 984 720 585 31 425 473 986 364 688 45
93 178 455 682 53 767 572 484 923 183 772 260 408 598 660 944 631 546 781 808
779 103 925 777 350 334 54 795 867 693 36 722 904 470 563 926 993 854 196 75
959 16 384 323 971 740 51 50 151 69 810 900 575 504 645 495 968 730 52 289
191 258 495 642 694 932 522 821 936 479 318 901 420 474 161 105 418 798 920 341
