20
181 692 666 695 72 479 259 258 185 150 221 134 642 254 479 491 46 26 641 377
16 603 61 543 792 600 603 560 991 257 995 560 818 265 999 849 629 41 17 948
126 594 954 925 727 345 865 979 765 365 50 237 930 587 713 434 775 854 103 220
258 910 412 6 669 175 918 954 770 828 542 376 534 887 378 355 196 868 401 694
694 123 776 936 418 656 927 680 676 107 834 796 874 533 138 28 9 732 718 916
233 424 340 384 818 411 997 691 693 238 636 310 996 768 284 934 351 741 813 464
809 537 825 98 329 714 259 878 281 561 169 170 652 283 536 86 501 44 590 698
599 406 888 82 48 495 186 638 516 31 382 608 759 49 337 41 414 121 154 178
296 253 315 78 691 40 840 960 191 832 722 396 488 720 726 795 408 112 311 92
955 828 534 892 515 648 922 202 574 636 367 842 734 283 121 512 378 901 931 313
997 619 427 406 916 289 350 208 137 834 745 405 547 936 23 653 631 990 701 765
816 624 903 41 827 706 347 388 601 565 332 76 231 941 584 161 832 5 814 991
513 483 53 347 63 363 740 474 868 41 868 604 622 476 17 47 866 869 342 724
743 61 842 170 17 266 844 234 296 987 644 891 873 223 254 708 816 793 51 709
710 51 379 232 620 869 34 8 572 195 326 431 135 9 325 230 131 327 624 501
481 147 634 400 953 85 352 350 399 62 926 678 261 313 226 237 559 510 246 246
950 596 756 325 16 533 900 890 520 455 97 884 271 71 971 668 576 474 701 293
270 467 874 663 55 621 387 586 665 889 846 307 706 783 143 298 281 734 349 158
922 926 643 993 234 351 444 261 230 295 159 341 750 397 743 257 630 594 253 6
161 165 749 266 626 591 368 434 481 722 619 988 928 638 83 924 363 70 529 480
