20
183 70 921 357 744 85 650 113 305 516 2 774 263 398 918 363 202 337 371 789
703 462 213 496 762 403 766 131 664 186 405 621 639 884 793 37 821 692 409 150
412 696 667 195 940 115 858 324 337 20 855 369 282 951 309 946 272 685 76 320
60 783 366 472 710 44 399 113 439 856 385 535 154 945 300 227 879 811 927 1000
630 272 205 601 605 293 317 156 487 709 752 789 588 797 97 603 221 518 41 768
775 189 385 322 764 699 909 972 156 200 898 144 936 967 828 895 325 462 810 663
122 136 353 742 349 532 661 938 321 158 360 520 771 417 191 314 513 182 534 99
743 444 49 390 642 401 679 493 103 988 124 821 859 682 808 467 59 2 787 381
126 165 677 603 47 635 36 867 354 169 156 541 753 798 95 925 509 547 123 129
884 25 829 912 636 170 348 837 862 876 102 669 213 528 12 720 717 313 20 30
456 120 294 519 857 893 541 985 266 886 57 875 779 795 597 777 100 527 284 17
526 818 720 861 278 706 857 152 971 964 860 442 606 662 151 252 730 108 946 901
957 268 291 63 507 841 199 136 269 498 179 894 491 174 989 992 988 444 791 272
94 735 953 309 234 456 858 711 502 31 224 933 451 429 633 760 85 409 710 154
848 884 82 575 295 950 121 756 496 793 871 157 265 890 739 362 175 862 484 959
102 806 81 486 734 885 467 831 417 66 811 340 738 812 534 616 53 953 506 520
176 899 726 980 220 413 570 189 726 703 363 458 623 412 653 912 584 230 5 603
58 588 253 187 286 949 769 81 787 7 495 929 287 385 886 533 46 973 358 944
45 159 265 394 63 869 784 186 919 975 346 255 970 990 181 947 943 823 843 978
8 349 813 994 881 105 541 612 248 356 68 316 611 465 382 109 320 102 471 712
