20
419 369 265 930 145 456 415 608 186 851 695 926 70 791 97 935 573 683 983 461
639 884 42 131 613 105 514 214 930 755 3 267 829 893 394 839 256 38 473 120
379 247 636 764 268 880 147 296 465 293 644 288 134 941 143 869 200 353 711 296
399 830 62 774 925 720 29 799 818 865 391 957 850 948 13 570 710 423 318 128
856 924 796 482 279 673 75 981 566 370 208 49 904 516 811 341 561 757 375 493
240 561 970 89 171 600 718 752 821 662 987 72 16 770 169 727 110 573 627 135
24 188 195 448 964 234 863 150 211 266 563 39 191 861 807 667 891 598 807 947
196 80 61 591 125 571 754 545 397 155 443 661 13 234 849 550 904 915 595 479
703 934 208 99 305 155 170 692 742 542 526 727 518 762 815 173 838 269 304 670
6 552 174 916 301 81 388 891 462 278 179 939 310 146 251 623 755 285 845 174
643 621 255 629 708 387 241 860 767 753 982 538 707 330 334 467 670 402 910 294
179 20 376 111 221 179 175 615 2 77 636 306 947 835 976 760 559 149 856 756
888 592 648 259 353 424 648 379 520 930 287 883 120 843 124 105 209 101 682 655
456 971 199 20 483 209 885 367 674 863 907 472 810 337 86 69 508 236 571 203
337 667 274 866 140 707 991 182 274 512 320 255 449 748 136 306 96 22 220 387
457 233 851 685 768 255 445 780 926 654 806 139 152 617 230 686 656 279 636 650
66 556 443 500 477 618 532 528 814 577 467 63 150 153 116 915 411 973 291 487
335 508 764 571 588 428 434 957 983 500 815 25 336 17 90 643 920 222 184 785
110 444 280 215 829 152 624 215 353 737 832 52 976 489 733 471 418 528 23 180
836 43 548 793 20 934 583 665 151 229 706 939 753 726 431 493 677 747 110 373
