20
723 207 778 917 774 425 100 456 849 173 495 817 941 668 58 115 824 610 81 576
851 282 936 672 59 660 920 532 575 882 259 871 366 493 491 275 173 766 344 177
425 571 794 469 318 169 286 880 377 312 176 572 864 430 303 409 87 802 778 665
615 989 419 569 622 852 583 682 809 387 608 274 710 193 218 529 803 996 859 425
871 121 217 363 312 665 11 125 157 750 708 509 927 911 787 157 605 775 913 318
182 56 645 725 596 884 225 439 925 282 947 473 634 327 620 211 200 467 517 248
58 851 867 513 62 26 673 89 720 373 119 88 748 728 93 461 982 255 240 771
121 136 171 157 269 613 750 820 478 521 9 326 589 199 46 434 802 998 746 658
668 925 415 680 990 842 832 857 578 912 220 819 557 520 493 700 533 616 985 468
175 54 78 945 409 468 234 523 723 441 727 61 30 554 896 826 246 604 945 713
122 583 152 695 829 617 325 629 493 887 694 796 82 81 107 84 389 959 556 64
889 238 228 375 465 749 280 761 771 143 917 24 830 657 407 686 743 438 931 868
316 291 924 653 809 3 607 71 208 258 361 791 419 379 622 881 369 991 888 26
51 15 962 998 17 242 89 353 607 74 970 545 899 908 237 877 972 258 121 228
969 223 740 44 866 482 128 127 940 65 223 621 35 137 348 46 194 725 214 676
530 213 553 154 572 267 73 109 606 938 164 103 326 454 816 873 609 514 477 712
166 271 465 633 326 348 575 441 177 555 460 432 791 702 127 554 118 678 787 77
914 236 396 718 797 227 213 208 593 497 400 232 217 677 878 617 825 878 851 821
767 927 946 185 743 646 572 557 927 919 535 29 607 985 392 924 161 310 403 74
286 614 986 983 237 336 261 439 468 133 996 685 868 231 15 470 503 933 697 749
