20
214 395 575 962 452 59 894 721 232 295 330 476 925 659 337 170 583 149 964 311
235 443 897 306 632 384 988 340 14 13 183 82 57 788 280 75 354 147 536 35
114 728 587 938 631 980 792 739 151 776 73 650 331 607 61 358 27 671 931 844
138 956 376 894 842 39 908 580 558 948 835 690 443 169 232 528 704 825 999 450
709 355 697 365 753 585 636 917 326 274 922 13 229 422 958 279 888 780 286 220
754 806 484 356 783 742 798 976 922 685 821 650 22 765 603 580 284 286 803 332
773 748 581 18 233 55 669 507 669 718 589 69 26 882 398 975 148 928 578 353
434 34 836 529 92 213 547 276 257 253 508 580 375 654 446 774 452 612 567 131
398 515 745 491 696 173 422 863 20 420 611 622 519 305 209 671 112 978 396 580
553 600 967 758 663 184 87 756 710 861 303 775 513 500 125 568 451 199 484 886
801 55 995 210 418 857 17 635 419 813 88 77 555 595 800 446 917 570 600 374
568 721 559 783 495 577 699 144 698 304 55 533 492 702 218 5 302 201 796 421
116 42 95 271 113 678 102 671 746 222 280 846 426 849 864 808 156 774 297 41
828 308 648 396 10 418 335 637 423 689 234 830 183 306 590 492 251 4 875 97
267 618 922 232 369 722 749 402 381 257 489 25 230 457 969 948 561 911 933 798
382 635 913 750 136 219 681 950 537 497 647 837 722 777 237 219 399 699 93 950
712 993 911 430 245 645 661 139 964 614 992 663 570 676 398 371 527 395 241 916
561 119 203 153 847 822 687 291 894 138 916 655 443 299 686 373 569 905 987 91
80 590 490 715 68 427 220 256 514 549 422 123 297 478 996 841 575 809 459 820
253 775 547 605 332 292 895 187 84 41 623 679 856 869 831 35 892 14 269 388
