20
705 92 96 188 869 451 6 844 908 856 453 454 579 320 333 893 573 544 727 889
963 468 627 266 635 298 711 762 241 393 608 743 707 28 193 910 815 273 665 368
397 140 881 409 879 170 424 417 896 354 806 720 138 729 917 90 483 414 382 196
13 647 897 283 192 456 633 145 451 276 661 835 802 369 169 500 559 592 534 179
481 736 776 28 131 43 265 582 925 768 219 307 640 937 409 802 752 208 280 639
749 647 234 402 885 837 86 352 891 755 644 7 858 646 165 104 958 227 413 919
485 591 803 729 904 728 682 763 872 804 996 468 860 424 356 966 158 574 592 516
677 288 901 86 236 760 701 901 337 745 74 197 27 148 696 851 357 95 508 868
747 567 574 305 564 547 164 621 942 628 292 946 412 755 819 233 827 844 563 333
765 770 298 790 83 747 742 351 837 440 90 943 666 874 778 832 674 215 746 572
339 91 710 13 855 799 232 705 787 460 429 448 423 726 349 158 379 737 495 112
127 608 491 627 134 602 624 602 506 679 436 6 564 78 132 844 25 379 403 377
136 84 617 583 643 642 835 400 213 793 6 723 948 155 232 978 40 368 302 852
464 407 23 932 479 389 669 729 261 76 910 830 5 831 539 148 771 445 221 850
512 651 551 327 731 946 381 117 284 120 440 471 377 213 767 244 325 260 264 723
184 949 868 401 806 923 245 872 978 305 149 403 832 743 715 340 298 364 842 423
566 899 293 89 487 934 827 177 586 86 282 351 880 611 162 454 148 303 762 871
92 79 572 273 130 339 833 696 556 211 40 559 79 450 300 58 110 430 664 355
988 293 573 928 546 434 550 323 487 518 677 304 68 453 824 45 91 387 737 373
718 566 270 903 727 139 438 638 614 680 681 32 219 10 482 643 105 497 79 141
