20
931 852 547 989 650 527 239 972 368 802 588 829 135 469 492 343 466 531 545 949
630 420 304 121 973 552 648 256 281 515 267 51 356 162 287 854 23 314 634 283
894 91 958 462 218 47 964 941 300 874 533 5 272 798 93 7 731 352 359 658
743 255 876 901 113 323 942 710 985 439 601 820 557 370 780 723 441 714 708 532
865 52 205 316 762 843 63 689 362 606 809 198 986 630 936 876 564 522 825 948
334 912 791 453 601 194 575 558 240 212 537 578 985 869 980 481 234 882 667 308
768 816 886 531 886 11 935 11 346 361 671 773 383 415 801 664 868 503 76 19
888 552 607 967 818 216 362 445 512 847 529 590 844 694 224 982 655 687 420 697
867 417 549 683 288 948 120 788 243 299 316 590 321 353 642 737 418 981 708 415
91 666 878 731 336 659 899 61 142 271 896 942 341 108 92 153 109 560 619 730
397 238 484 62 534 662 664 252 871 252 80 144 525 932 692 570 542 647 170 300
165 954 495 513 588 428 105 805 10 67 963 675 269 244 620 317 640 565 412 951
924 945 585 261 398 948 862 766 49 620 362 586 426 819 516 320 240 799 892 476
318 666 13 330 202 994 418 333 415 277 785 135 728 859 829 175 875 626 914 416
240 851 139 879 190 480 990 989 395 866 356 729 308 445 988 752 89 449 191 813
772 482 604 638 824 126 656 956 297 336 341 914 421 522 174 35 961 417 241 948
777 779 44 255 369 775 615 581 663 684 678 512 934 810 961 625 517 358 512 478
513 240 907 326 411 85 460 660 673 794 382 271 661 493 303 236 92 356 979 622
223 526 177 309 351 92 146 904 132 924 745 73 995 975 569 970 306 601 168 852
849 368 150 166 94 438 606 341 855 386 930 981 198 955 203 774 196 500 654 104
