20
744 263 602 301 419 959 950 462 85 320 474 693 950 496 217 485 959 211 382 212
20 255 672 818 295 747 100 456 607 329 746 83 124 711 560 123 619 938 780 580
762 336 140 841 755 658 593 677 782 261 80 513 141 345 538 611 9 449 339 675
863 733 396 135 431 745 558 327 15 430 591 338 16 161 481 427 540 1 756 119
357 735 164 610 884 671 620 552 185 436 949 544 244 776 527 645 481 208 147 580
585 462 463 287 685 697 513 374 616 913 669 493 262 32 315 543 723 500 191 950
766 961 699 733 109 95 668 609 900 230 451 82 283 232 772 59 394 459 848 82
599 751 453 85 539 721 37 292 143 114 462 412 477 709 783 749 228 862 614 637
902 964 297 659 865 278 426 687 413 433 485 207 275 716 287 139 353 398 335 250
101 220 411 278 851 199 127 549 802 271 433 418 949 202 448 954 116 85 267 3
491 439 456 223 807 640 729 790 201 874 481 229 144 338 446 297 144 972 774 86
969 564 778 292 578 903 689 581 9 781 203 828 134 810 613 675 311 924 507 158
998 438 700 64 238 483 125 330 216 495 64 615 451 46 445 487 333 671 586 456
251 137 888 318 177 424 380 841 368 540 847 882 638 658 1000 310 305 124 195 613
771 553 250 78 477 659 347 729 881 489 412 902 660 357 38 942 18 345 508 324
319 970 820 160 929 777 781 233 759 524 489 837 832 841 367 332 877 749 511 94
370 123 279 742 801 437 187 107 321 749 827 449 32 299 204 954 875 692 478 65
940 978 660 323 199 75 619 88 343 865 657 488 913 783 219 628 254 150 912 814
669 539 598 438 776 224 535 189 861 146 223 506 453 531 900 731 5 25 114 434
421 238 299 434 77 509 637 832 561 478 150 374 297 728 374 799 211 871 828 920
