20
208 880 705 829 387 505 247 577 850 80 20 765 48 528 583 811 360 491 763 169
766 672 655 891 976 823 71 936 913 785 138 922 793 859 652 1000 692 258 550 178
360 326 300 95 506 328 461 349 106 854 822 539 803 918 617 330 248 892 849 527
186 783 537 141 135 697 155 116 68 21 433 281 290 524 721 849 976 415 347 515
975 256 497 646 387 565 273 454 678 319 922 214 717 705 681 873 498 335 162 285
381 557 217 655 439 374 330 150 226 759 326 18 225 651 460 391 625 837 884 22
882 406 352 66 244 714 673 203 937 189 759 317 12 360 74 936 161 397 852 968
939 638 247 63 537 194 231 5 572 870 939 58 520 221 150 705 941 619 976 597
646 934 769 731 757 234 958 761 815 757 335 867 21 220 477 793 259 300 494 439
187 150 787 743 103 344 315 800 780 67 745 567 188 515 52 214 814 519 988 967
960 174 295 778 479 978 416 13 731 759 938 420 560 495 385 634 838 648 778 589
112 567 20 713 930 74 166 707 664 997 118 218 540 466 230 442 203 952 36 934
980 104 796 709 285 794 600 619 635 160 86 815 678 136 35 861 268 68 502 397
400 36 974 703 956 227 804 812 746 363 90 504 36 470 982 678 313 567 416 316
19 324 469 710 630 427 541 438 25 783 895 862 374 837 828 685 825 456 860 657
265 834 516 267 259 509 471 537 589 809 587 422 536 500 189 591 837 865 185 653
44 719 562 930 850 914 539 145 39 23 495 395 64 758 393 311 281 664 747 574
64 491 342 48 285 58 931 21 618 583 265 421 618 277 110 498 436 177 293 293
138 176 677 877 521 527 659 826 251 120 839 53 670 246 840 892 605 841 957 522
585 236 661 844 70 59 203 987 419 42 497 23 823 212 440 973 950 587 447 123
