20
135 43 589 192 881 998 985 923 885 281 107 339 358 953 528 988 144 88 711 454
200 388 674 994 370 96 991 73 567 740 36 325 824 186 428 103 342 556 912 648
138 278 912 533 813 696 256 897 835 397 222 506 589 166 219 341 12 252 972 75
251 256 150 261 281 924 133 5 921 53 80 704 216 900 516 32 302 389 528 142
780 656 795 892 211 326 720 96 987 232 255 929 348 378 194 280 634 852 202 581
863 438 707 994 967 683 613 987 283 310 498 394 184 598 805 247 364 204 866 83
369 400 539 669 591 663 882 804 169 137 522 904 598 49 692 407 145 40 294 267
670 456 121 689 204 733 11 988 502 564 808 863 405 870 890 568 284 678 181 635
386 602 590 451 651 28 276 896 119 754 576 703 766 508 71 834 630 186 770 700
55 877 102 315 953 754 979 211 49 525 418 320 441 74 842 913 226 469 834 426
685 102 290 341 438 835 664 295 592 236 485 112 322 48 570 646 860 687 886 614
767 997 877 885 294 27 278 11 997 106 839 856 211 787 908 174 119 432 885 42
782 125 20 119 503 911 912 865 473 76 882 226 706 626 368 571 636 684 329 876
973 643 464 353 336 550 202 493 115 855 342 513 674 44 406 147 6 49 575 603
600 802 152 601 926 393 228 165 665 435 754 747 234 960 522 795 742 215 818 169
390 439 932 158 161 148 389 5 52 767 632 716 414 400 746 944 473 637 233 444
308 622 108 959 785 164 372 307 503 621 750 905 654 116 102 423 212 629 539 485
411 787 680 524 50 763 382 956 90 179 154 761 613 249 299 655 936 602 677 351
69 874 910 449 707 130 661 790 231 393 857 114 395 538 198 694 890 535 387 40
264 934 768 592 883 928 60 466 19 366 802 660 572 329 193 751 941 853 2 70
