20
232 937 399 614 362 926 7 926 200 8 508 534 744 440 398 104 548 115 452 463
349 427 482 642 919 784 870 715 485 55 217 375 910 363 849 22 645 690 623 682
401 354 157 878 737 793 163 842 192 970 718 454 620 488 706 719 885 374 228 939
903 789 806 53 323 777 830 10 960 106 210 864 468 21 743 278 26 865 591 558
211 837 654 832 166 928 121 884 140 706 325 939 8 536 485 145 859 647 833 673
444 82 63 451 313 362 710 578 199 243 954 870 3 315 235 628 107 884 990 461
232 439 728 79 489 554 338 712 786 107 434 66 693 759 785 749 231 590 498 571
557 950 678 867 249 609 616 397 686 96 941 197 335 154 229 316 350 371 617 29
155 274 679 276 870 118 138 842 237 977 537 774 819 931 415 339 94 243 571 311
787 220 472 1 600 343 947 936 357 792 75 498 833 573 419 777 502 889 343 175
505 43 206 563 640 234 651 74 879 454 531 112 218 148 713 592 871 646 663 815
74 382 967 565 363 112 425 743 122 959 402 705 985 960 139 536 595 799 368 343
604 756 106 67 727 750 275 707 365 322 48 892 431 385 212 255 793 381 272 421
167 986 560 311 896 209 719 339 3 656 185 404 39 174 498 544 246 794 577 827
235 618 146 856 120 557 956 88 377 450 670 875 440 502 171 823 376 24 975 166
458 182 199 822 308 497 110 389 69 121 735 223 419 827 793 312 966 264 99 662
998 950 242 536 465 621 493 723 12 583 926 693 550 79 284 858 323 357 671 380
321 387 520 519 824 422 785 336 257 554 146 401 111 730 385 401 947 650 331 553
59 142 96 89 393 567 608 293 210 690 512 524 638 614 223 907 93 129 303 187
896 229 850 522 608 174 19 262 625 444 5 422 482 418 347 336 140 660 40 505
