20
546 133 493 73 238 527 657 989 814 993 473 482 912 223 510 640 600 885 996 518
514 696 769 968 74 861 870 60 477 706 964 151 751 23 203 246 56 28 257 688
352 496 773 771 933 563 686 281 786 978 805 44 485 34 435 608 730 636 66 509
195 516 346 560 580 439 436 354 96 61 570 588 851 98 158 991 971 794 722 773
595 266 115 789 775 16 245 630 873 965 922 838 71 747 878 993 383 624 223 955
993 592 604 996 396 964 350 270 542 434 876 961 922 252 579 533 183 316 589 938
580 842 32 58 48 810 363 433 554 246 908 779 52 999 776 701 43 291 422 980
686 55 43 180 588 249 751 963 972 445 546 41 195 199 480 148 610 252 88 122
701 512 63 424 903 21 237 4 224 667 723 571 814 396 189 34 400 603 34 819
600 596 243 123 789 458 361 917 418 504 637 650 361 414 904 123 802 132 804 302
715 768 860 850 118 706 776 194 444 943 99 912 257 748 764 167 771 784 920 610
78 251 226 372 543 801 34 356 685 801 706 297 632 846 860 340 469 97 673 583
923 972 991 409 18 714 21 843 232 374 755 131 757 378 674 468 797 193 77 293
698 832 296 573 801 404 688 844 172 565 256 349 168 758 873 318 525 331 349 97
703 964 866 628 102 372 741 519 556 590 430 808 533 858 114 12 312 404 793 524
180 984 800 25 568 885 728 620 775 373 127 968 852 356 176 78 967 822 245 984
564 536 74 342 591 785 628 942 237 406 262 967 199 328 2 281 335 958 962 15
53 686 457 907 163 600 840 821 688 154 138 995 540 869 377 163 243 786 737 409
891 879 985 299 895 374 206 693 975 735 62 637 60 871 806 415 624 57 543 275
842 690 735 805 453 78 645 428 311 293 467 597 988 950 441 440 435 118 759 35
