20
755 935 902 751 286 700 910 840 228 186 20 43 315 295 346 802 715 206 967 519
940 787 550 4 923 837 951 251 228 736 105 177 581 699 74 786 291 882 858 118
230 645 509 965 444 950 393 944 371 791 144 242 584 451 532 66 389 227 679 162
710 280 292 70 885 490 928 724 760 893 702 481 20 560 667 828 798 458 136 505
691 583 728 660 712 146 236 304 515 467 898 494 353 99 814 551 878 879 490 636
503 283 597 572 559 993 447 107 241 648 213 722 842 736 807 156 24 805 151 209
123 283 719 565 134 932 414 211 953 108 888 56 824 781 681 539 377 171 444 234
304 298 590 646 907 308 641 705 638 644 474 390 929 753 745 742 523 929 262 371
920 268 943 85 150 859 108 181 764 15 555 226 445 482 572 960 189 509 393 239
929 946 677 583 907 885 729 221 141 493 63 439 305 90 406 669 986 127 190 305
557 32 303 281 26 379 795 281 60 565 656 808 541 479 428 544 184 2 547 588
348 295 298 115 862 895 135 802 740 395 369 337 102 839 706 120 472 459 41 623
602 80 720 581 32 933 174 761 125 644 97 762 503 859 431 950 981 49 221 297
326 849 372 729 831 212 681 924 316 577 850 982 809 806 345 111 273 529 156 638
56 506 329 987 154 993 396 797 947 492 455 509 250 989 737 978 286 850 916 910
430 262 641 397 377 470 289 227 274 302 259 786 520 651 674 311 19 462 355 89
528 939 679 741 786 743 224 652 88 581 306 275 24 847 132 776 201 515 624 592
807 138 943 709 322 189 87 950 931 479 284 743 156 313 547 183 452 25 294 48
368 16 247 600 893 851 352 379 528 358 640 786 866 454 658 669 909 743 355 926
709 828 463 528 928 873 150 717 383 502 891 45 978 282 745 221 609 968 853 3
