20
259 768 540 481 189 969 38 295 303 646 468 795 375 766 380 762 378 234 213 355
331 809 678 240 518 789 722 204 371 725 577 79 920 513 709 817 525 380 403 556
351 197 836 902 718 211 195 729 388 646 638 899 903 720 261 448 639 176 523 661
927 962 74 354 375 370 572 282 803 645 511 446 411 435 689 805 751 402 431 688
673 499 794 466 401 107 788 837 637 202 42 41 51 569 440 28 366 944 62 467
694 933 188 25 807 215 134 454 416 567 907 50 992 379 307 321 449 641 598 991
470 189 549 304 564 101 512 95 262 722 120 876 90 291 9 499 735 959 336 210
361 882 36 372 950 525 391 554 114 870 544 589 911 419 628 814 592 776 662 961
414 862 308 132 535 459 127 952 770 566 606 903 261 463 7 20 177 282 991 728
548 245 133 614 247 965 580 830 384 914 380 85 84 51 585 702 956 656 398 621
577 374 204 627 862 354 921 30 36 254 325 140 426 417 92 986 412 684 737 361
498 706 202 191 17 337 965 493 941 397 721 2 342 687 430 587 779 201 275 941
50 367 895 109 382 61 316 470 219 997 655 584 586 493 353 999 32 891 202 992
303 230 30 728 942 431 408 887 734 441 531 497 831 560 848 915 339 490 774 118
396 411 346 666 919 940 321 789 819 773 565 909 322 555 86 424 250 463 637 297
291 845 994 757 439 579 897 893 619 824 664 280 264 375 286 368 287 91 281 99
341 649 371 904 156 104 96 833 322 192 816 165 832 68 258 434 344 128 535 659
249 418 973 455 322 371 818 912 400 568 587 175 549 292 258 476 156 830 827 306
904 560 1 718 612 889 210 992 513 91 502 148 58 596 26 817 928 830 108 105
110 168 840 221 240 929 399 678 487 28 897 571 766 590 273 551 622 928 709 315
