20
800 443 343 806 962 444 620 630 774 840 269 686 545 954 819 336 311 303 166 461
169 741 241 496 229 771 377 813 909 47 331 180 659 484 227 452 549 519 55 666
264 616 440 14 832 20 897 517 718 20 234 428 478 380 642 105 990 751 64 321
958 903 964 368 527 925 871 52 257 194 742 515 562 548 70 76 164 181 775 321
761 381 871 551 398 366 663 712 219 558 346 615 682 306 573 23 644 276 745 454
245 395 199 389 921 795 478 947 948 77 135 213 382 795 897 10 422 282 483 401
138 883 580 678 718 294 128 643 318 821 241 963 590 12 105 978 189 204 823 696
62 157 798 70 802 211 380 856 943 262 392 218 357 910 965 723 656 701 696 129
634 901 762 98 470 916 764 488 910 321 489 175 342 200 488 717 811 980 795 670
97 529 11 369 87 427 62 50 589 280 90 431 228 918 244 942 47 203 240 593
509 946 140 724 811 973 89 325 621 309 634 422 182 493 782 657 562 908 569 199
9 683 581 409 488 671 138 782 639 562 920 454 522 493 52 912 774 965 820 609
405 24 816 459 744 817 24 674 953 108 15 319 862 404 327 36 137 78 712 735
358 93 763 525 885 394 973 22 542 647 76 121 364 952 797 684 483 791 641 819
812 531 181 851 646 921 705 753 251 384 231 413 266 758 288 420 502 21 723 324
718 642 387 542 485 361 266 815 93 264 764 291 247 336 231 509 323 417 327 500
852 136 587 829 460 259 881 577 548 906 44 331 420 906 679 241 228 299 180 65
623 640 632 733 595 166 859 32 237 714 80 321 285 317 889 898 789 632 830 538
892 587 3 597 651 778 126 10 685 723 864 360 589 859 364 667 125 863 867 770
699 826 724 190 626 118 126 783 591 904 35 335 120 118 614 574 165 132 550 591
