20
893 747 806 257 643 204 84 886 45 752 142 709 785 323 738 78 766 866 459 558
387 642 134 37 458 566 298 872 491 213 247 315 14 925 244 92 305 122 168 998
984 813 210 395 601 215 584 213 811 249 326 539 430 338 766 347 663 145 643 463
566 815 434 750 452 9 918 297 847 134 834 249 973 901 234 680 930 433 143 827
550 131 34 959 643 171 322 867 272 751 581 585 314 134 348 116 838 986 890 177
125 864 934 708 383 970 32 90 303 200 480 610 674 282 463 891 140 992 595 305
775 889 984 181 726 560 411 759 634 316 338 37 300 400 792 457 194 6 616 405
136 291 68 2 484 862 738 407 11 519 719 154 998 192 437 57 984 864 869 989
791 83 412 560 345 221 573 907 886 310 74 667 337 242 333 120 385 129 662 920
110 701 815 411 873 245 647 519 29 135 692 89 580 149 46 994 20 602 981 684
328 936 448 551 638 708 424 111 128 64 758 161 575 61 705 946 463 887 74 444
804 246 661 275 688 860 341 124 44 257 179 691 275 394 225 750 716 157 482 86
721 261 624 990 465 962 278 415 561 275 409 753 851 827 317 930 756 215 373 873
213 469 324 197 878 598 949 816 643 998 774 870 946 355 584 694 293 671 5 230
554 662 54 188 748 479 732 436 498 8 655 859 427 393 509 31 100 419 334 646
235 470 212 714 674 656 116 910 427 628 819 475 362 862 916 719 18 806 749 221
833 872 954 129 452 966 313 954 353 212 494 502 360 782 110 946 113 527 168 806
731 323 332 339 943 963 763 774 369 19 222 169 481 260 453 317 612 423 806 918
702 103 24 286 981 545 662 169 151 422 325 120 413 219 800 144 112 905 856 828
715 990 881 489 624 43 231 742 652 369 191 677 130 307 328 452 230 38 82 587
