20
979 826 810 708 181 522 824 505 560 521 892 8 790 492 753 584 748 482 119 493
729 18 467 38 627 181 938 736 84 268 569 827 549 985 514 911 27 844 54 693
712 498 91 209 12 10 639 153 977 85 847 691 782 672 453 53 856 711 881 497
706 874 4 584 518 734 786 301 91 498 630 550 502 186 945 891 640 780 42 443
632 719 718 797 111 961 470 849 766 538 356 76 88 92 937 166 506 936 196 203
157 555 202 95 595 915 598 662 7 793 954 936 675 526 331 686 91 465 935 730
378 468 678 75 246 113 668 557 395 475 498 910 71 541 298 825 480 40 887 372
64 809 675 417 645 608 482 348 249 206 203 43 377 835 307 247 519 182 134 303
898 696 239 346 503 870 1000 346 404 953 516 933 215 764 956 53 937 232 125 587
108 320 936 922 653 604 191 11 105 219 38 529 974 25 561 836 286 562 528 370
542 944 744 422 860 961 234 317 56 671 917 37 901 144 212 684 611 277 909 852
264 86 818 673 304 428 102 872 16 304 250 713 687 732 980 587 694 319 699 914
893 19 380 798 887 524 862 700 287 205 148 984 442 919 262 131 728 512 839 577
315 328 397 935 358 865 830 720 483 146 687 987 574 695 438 51 95 460 820 42
577 666 486 777 502 530 952 743 457 813 699 737 831 396 358 23 747 40 720 8
733 63 555 626 232 497 301 774 966 357 161 787 587 193 949 960 697 88 21 525
299 513 436 432 545 570 444 521 973 136 881 426 62 239 579 883 789 843 115 737
176 418 408 438 526 812 517 279 894 603 841 549 359 65 313 238 92 343 927 453
437 214 147 165 539 748 598 90 301 299 981 1 740 859 746 32 646 362 161 473
982 602 215 533 96 628 65 715 731 26 318 662 357 627 37 634 294 933 427 739
