20
266 97 733 6 639 330 332 536 904 987 400 547 840 907 22 742 758 733 141 673
285 940 543 969 212 930 727 209 898 864 944 713 149 886 507 316 605 469 864 755
275 373 548 203 101 706 10 277 212 853 391 847 438 518 915 216 414 937 908 308
373 421 520 679 378 913 572 397 757 61 27 63 648 481 411 71 48 359 656 62
153 154 239 946 958 82 650 275 425 472 481 463 576 18 253 176 887 174 774 776
4 610 308 203 111 166 483 418 270 608 379 453 341 644 279 470 954 426 679 423
564 258 87 736 543 642 703 780 37 445 414 84 599 634 821 643 387 179 241 669
336 741 299 471 331 743 955 761 265 868 511 896 542 431 734 584 649 748 135 998
52 177 129 441 801 31 793 764 302 729 932 476 622 684 719 580 802 365 982 240
95 296 621 440 637 949 617 163 366 187 184 296 675 178 838 363 79 348 291 972
779 36 779 421 644 85 796 909 341 396 762 830 585 675 707 51 514 882 452 567
770 790 380 853 950 852 333 481 196 229 52 729 977 829 296 353 723 356 785 139
231 559 933 630 829 992 770 491 650 733 545 599 392 575 60 6 683 799 288 911
660 950 84 620 488 639 300 149 833 809 162 236 886 464 499 695 659 818 209 764
306 796 811 170 606 85 801 74 896 813 351 573 901 337 446 571 295 40 76 33
303 565 837 892 209 27 130 331 279 859 725 830 427 116 21 226 719 745 516 71
77 446 422 824 347 945 785 41 622 485 265 91 728 525 187 46 235 391 555 682
929 45 449 63 184 893 788 687 358 105 753 730 122 37 949 866 98 914 612 212
996 419 961 957 980 841 579 201 365 618 558 251 212 680 276 89 671 282 605 862
171 260 375 366 103 996 574 9 170 6 305 491 88 867 746 311 430 566 227 823
