20
519 363 721 609 762 258 230 905 81 117 213 61 234 699 928 305 298 79 294 357
544 979 757 772 221 968 368 191 1000 457 812 456 741 771 94 3 394 524 852 647
935 951 787 696 868 56 573 131 582 973 844 175 559 396 926 660 410 454 502 832
18 401 755 147 286 31 159 16 382 419 603 949 820 763 881 225 305 821 856 168
59 349 677 9 822 194 270 128 976 283 345 580 467 314 762 156 936 685 171 327
309 203 230 675 338 973 528 245 267 582 321 445 349 813 993 595 366 771 196 784
983 666 733 735 825 38 803 673 714 747 47 967 480 826 98 176 237 628 558 879
829 484 994 148 625 786 614 321 978 571 663 7 429 479 943 53 612 319 213 298
361 748 806 993 536 365 978 366 951 978 825 783 211 477 656 410 879 403 393 60
43 237 584 900 430 390 133 780 3 678 754 904 419 124 279 581 540 453 575 380
304 496 386 258 781 752 54 675 691 411 308 301 728 518 665 59 846 895 13 425
493 807 51 886 891 424 642 512 210 686 749 186 816 276 517 50 632 607 821 538
742 193 934 447 374 806 502 512 686 364 708 585 289 677 874 107 173 699 368 368
800 925 47 176 797 411 93 217 870 653 189 859 823 621 838 716 860 164 461 287
97 543 246 561 190 505 594 370 342 629 202 540 332 773 65 685 832 674 647 6
512 806 825 868 465 788 799 543 56 362 527 898 14 587 987 276 201 922 373 172
245 170 493 827 145 123 35 824 52 782 269 519 980 204 540 172 155 531 476 97
860 537 532 134 279 933 721 388 526 852 737 649 966 192 181 614 892 837 707 395
737 386 332 542 763 677 111 876 972 14 34 99 766 903 120 309 288 795 500 307
326 794 763 633 997 586 22 313 416 271 520 219 184 520 90 263 409 216 530 330
