20
521 656 435 98 457 900 938 303 594 99 676 702 143 290 782 41 574 749 596 170
395 532 537 373 734 802 894 71 815 341 640 706 881 831 431 856 573 529 667 1
634 980 233 412 9 56 491 580 584 380 118 953 6 579 629 461 171 558 955 30
594 210 835 444 371 228 70 833 92 4 567 812 805 884 628 620 350 668 205 862
696 762 248 884 301 762 439 287 157 353 250 501 24 62 843 819 772 273 747 619
543 822 458 912 555 766 896 860 328 222 280 904 967 145 399 581 603 267 272 585
220 869 411 581 28 792 649 763 22 922 892 987 455 705 832 835 800 813 560 324
494 594 883 31 155 207 926 634 643 345 257 212 462 530 783 343 192 962 454 423
187 293 503 99 225 840 526 456 962 451 763 626 662 11 414 225 832 93 434 444
475 995 359 101 152 186 901 18 567 390 33 989 861 241 754 324 841 330 794 789
499 715 665 716 653 484 171 822 274 969 556 80 561 739 249 727 32 624 243 867
125 366 454 213 355 965 819 628 375 397 560 124 286 452 916 684 419 71 252 908
837 552 343 648 894 668 416 908 470 813 338 39 330 379 171 4 888 27 992 880
572 337 30 32 129 647 887 668 277 491 305 245 404 639 579 844 440 103 975 151
576 891 899 235 473 819 572 144 453 459 152 835 98 216 301 144 247 334 365 166
887 263 407 831 41 688 239 468 617 287 687 321 770 394 815 189 136 887 852 878
95 256 574 763 630 180 199 447 495 445 196 661 621 822 809 646 80 47 191 400
990 422 921 287 809 310 133 775 907 89 749 228 375 702 854 188 97 299 493 801
420 587 627 864 971 282 842 353 328 631 864 519 666 26 184 127 12 792 995 353
144 518 867 429 560 797 310 323 181 17 888 759 976 358 892 614 882 596 748 645
