20
71 919 941 564 515 305 728 628 516 80 304 722 171 732 731 826 749 875 137 848
741 660 568 374 899 60 235 802 915 322 684 973 203 998 184 574 99 561 662 844
936 42 245 546 969 196 688 150 480 779 331 272 536 231 695 986 223 241 990 728
578 647 240 514 110 557 192 181 663 951 942 344 396 245 594 653 481 95 961 622
352 12 223 457 916 747 587 297 456 974 312 223 89 164 501 277 522 837 635 498
484 654 865 637 734 689 185 279 637 423 795 577 861 390 619 248 860 332 891 733
255 551 900 888 225 493 88 505 911 183 906 306 75 804 840 970 230 355 158 259
549 944 103 89 869 795 629 316 948 652 100 213 576 589 574 667 695 299 588 142
774 3 315 258 274 281 387 785 83 675 804 641 245 392 734 768 509 250 880 574
226 512 1 128 389 561 413 464 408 127 762 469 823 504 674 8 171 622 847 170
63 173 211 272 933 982 716 475 906 940 508 973 941 487 275 254 997 707 598 663
766 759 942 975 282 345 838 77 659 946 634 379 97 781 288 246 393 594 861 406
479 894 454 639 505 377 581 136 996 537 642 822 891 72 319 391 574 507 9 87
929 275 297 24 92 751 274 751 518 278 808 204 364 383 799 783 349 630 509 44
196 409 843 883 272 53 864 527 752 669 293 401 121 245 142 165 117 419 233 843
14 985 788 983 720 555 334 57 262 925 262 810 786 5 934 578 341 352 659 292
904 303 896 194 351 449 423 644 497 355 571 708 550 564 750 189 555 629 39 749
508 907 878 586 594 555 876 5 590 482 869 784 125 864 38 969 84 904 674 844
316 185 539 313 747 948 363 580 561 169 765 295 529 29 669 659 7 448 179 626
961 191 820 505 902 456 890 9 478 254 284 266 827 158 31 245 489 344 401 128
