20
122 377 166 201 796 981 548 613 397 860 69 847 235 493 371 484 749 669 684 333
111 434 508 9 73 290 621 985 675 174 724 635 880 148 114 869 171 645 670 406
254 622 180 957 435 861 59 10 774 741 145 97 187 682 251 282 424 876 923 220
494 876 394 713 743 755 954 469 700 258 808 699 595 512 703 789 388 774 43 968
249 309 232 456 261 504 723 705 346 914 122 545 531 762 942 357 796 141 46 803
582 539 990 672 444 684 657 340 774 853 854 102 521 283 538 961 844 398 429 606
350 313 323 121 543 4 216 438 347 770 90 87 880 906 105 641 385 158 865 70
793 802 220 790 580 316 350 775 665 910 652 571 188 823 871 40 929 6 975 663
588 210 227 148 627 567 123 556 383 72 14 946 762 309 162 728 187 590 736 790
214 616 675 227 376 265 359 5 230 831 203 574 878 42 434 770 227 551 738 203
870 755 709 755 766 453 493 491 652 312 718 638 571 52 640 845 805 974 499 785
178 189 460 789 774 891 64 551 727 152 38 70 714 135 129 868 369 428 659 337
584 404 451 640 120 799 943 143 527 14 176 224 483 293 367 888 388 200 74 192
603 957 603 664 791 73 28 400 252 138 162 673 945 770 263 207 364 123 78 2
473 416 438 997 464 932 277 955 942 881 863 497 652 342 266 50 516 31 197 369
455 955 326 65 459 441 454 887 139 42 332 690 673 407 720 740 943 520 474 494
232 66 555 885 560 813 345 203 60 919 245 675 361 197 629 38 708 796 583 326
975 761 212 93 453 79 686 592 934 649 101 102 148 657 839 379 133 248 582 298
81 921 995 320 358 90 104 217 849 836 986 650 756 187 420 142 24 1 446 751
714 85 352 480 24 551 404 304 992 17 13 838 455 981 552 770 528 564 784 915
