20
749 341 8 71 275 982 993 177 784 399 164 477 831 323 150 841 614 710 548 424
930 187 307 314 658 560 741 198 906 383 98 974 967 727 857 885 670 771 441 238
140 8 383 298 962 695 353 479 475 396 124 847 915 88 607 244 824 187 816 805
451 268 10 336 789 912 61 366 530 587 913 13 586 280 374 975 169 397 154 784
399 783 87 299 369 29 30 631 579 323 828 960 785 639 166 469 922 847 309 556
369 135 520 268 337 589 645 481 15 138 630 545 473 867 488 301 535 104 132 285
305 58 529 263 350 210 919 819 980 957 704 622 420 22 1 297 633 101 777 795
725 67 261 227 891 560 819 165 459 256 211 732 390 385 662 202 952 587 378 414
772 943 190 120 183 929 954 424 124 566 919 284 639 934 940 502 635 52 756 232
576 258 264 969 767 289 689 235 470 816 860 710 70 597 565 455 582 260 495 169
509 398 907 904 839 931 87 816 41 266 144 583 108 61 537 388 860 747 220 677
2 259 369 919 402 466 912 1 582 321 761 230 398 120 939 36 926 970 125 28
40 47 956 313 423 9 719 233 16 234 685 382 56 486 704 245 17 553 176 617
244 675 374 964 277 187 909 531 39 973 28 742 617 467 570 788 319 405 902 11
57 289 682 16 925 729 363 991 551 554 604 827 178 856 345 412 641 447 663 418
689 27 489 94 647 571 740 616 943 801 79 887 104 998 388 491 251 628 868 921
553 909 662 318 502 362 957 398 581 536 339 336 267 10 485 790 169 874 307 448
117 206 94 153 682 911 862 406 331 41 338 125 416 881 861 208 79 495 840 475
529 50 954 91 322 603 356 751 99 33 883 314 698 826 359 793 670 983 668 627
699 647 119 574 177 347 285 226 446 386 328 764 439 886 3 935 824 752 894 715
