20
468 145 532 103 651 924 448 508 969 479 699 739 421 189 18 33 508 556 923 641
477 363 379 443 855 962 623 47 360 507 607 876 698 596 726 725 115 939 279 664
427 821 707 795 360 967 671 668 566 232 34 520 557 784 281 542 644 566 166 142
816 571 350 728 427 661 481 370 942 257 259 283 813 735 458 71 352 578 676 288
428 935 789 294 264 347 841 297 85 58 135 508 709 938 982 408 155 438 406 962
523 490 56 874 566 252 563 102 987 338 62 183 543 627 63 13 307 808 525 935
894 67 386 841 876 873 572 418 26 893 729 221 631 609 101 183 482 896 261 741
436 888 943 644 263 324 755 275 218 589 868 396 255 301 75 945 585 542 188 565
375 968 153 72 989 596 956 613 540 856 158 320 689 850 940 926 245 413 312 21
256 292 767 453 287 223 143 422 737 279 835 101 119 311 714 512 810 149 298 519
484 517 318 151 816 798 251 510 58 122 523 941 973 490 640 975 414 28 528 345
592 44 731 729 1000 481 796 889 823 381 88 669 2 229 98 168 890 221 190 301
18 6 214 446 56 128 77 723 474 79 701 728 560 159 355 632 36 968 447 593
376 143 924 497 817 258 715 947 156 167 985 482 506 273 854 889 957 90 821 378
495 628 712 111 184 404 206 48 317 277 74 132 836 525 713 706 37 382 960 220
980 131 455 313 748 563 6 166 222 605 262 389 95 344 860 51 792 725 701 633
696 250 361 800 472 946 208 696 648 34 445 483 100 793 632 522 450 877 379 771
813 265 937 73 90 73 613 749 511 57 315 211 214 641 110 101 751 843 96 215
488 965 299 779 690 704 543 62 112 804 222 471 920 490 320 247 673 1 249 699
399 874 675 596 187 354 544 820 992 730 131 383 936 171 463 772 248 192 276 742
