20
311 766 557 54 944 557 576 860 586 695 985 938 61 558 113 934 151 311 594 186
962 754 173 873 948 684 169 870 5 653 56 749 160 595 420 403 951 801 406 357
166 613 801 287 430 506 936 675 410 762 336 988 758 921 834 617 677 676 266 744
444 422 473 570 4 493 962 664 272 304 606 219 668 966 920 278 422 258 767 434
491 170 112 939 863 734 741 387 220 80 199 703 817 739 164 466 8 822 203 356
216 250 126 177 204 926 101 608 405 796 480 392 421 640 455 279 649 572 830 411
510 240 861 358 969 537 389 333 318 284 581 896 483 20 732 491 90 646 762 452
413 220 674 978 652 362 939 870 317 590 708 635 9 743 77 498 816 427 867 310
824 40 252 8 486 850 939 915 284 758 704 659 16 188 773 517 620 397 923 708
469 222 21 512 315 240 71 89 163 669 894 420 805 409 240 226 833 155 901 688
218 143 868 315 356 909 358 589 586 914 268 876 790 382 24 818 893 727 188 118
521 596 36 780 227 42 180 220 114 859 818 724 403 872 179 539 376 726 320 849
271 435 50 990 414 300 10 145 834 610 504 882 741 47 980 301 952 20 819 432
303 233 533 886 297 331 616 440 200 779 680 913 784 879 784 669 574 771 182 928
62 803 925 58 816 602 675 258 840 956 143 81 623 126 378 438 90 437 349 800
230 999 439 362 962 954 586 641 297 923 453 903 891 823 113 118 8 444 956 232
409 370 361 224 602 444 643 349 255 867 769 865 946 174 833 542 123 9 688 998
130 556 518 779 477 960 103 115 570 914 987 551 923 393 443 422 756 57 351 427
21 484 368 44 448 826 476 891 755 692 568 219 254 808 310 429 562 623 392 644
950 882 816 495 927 279 232 15 736 832 721 635 813 883 649 107 221 979 16 560
