20
120 356 189 713 990 288 530 526 280 56 461 5 567 739 165 981 194 410 411 409
487 54 706 634 476 308 300 152 818 951 982 116 427 551 89 921 366 809 365 44
116 201 741 871 434 931 18 290 734 986 862 378 440 768 118 598 284 775 713 510
334 112 130 826 655 273 216 48 828 349 641 950 324 214 233 943 91 941 409 886
228 132 874 919 138 299 157 905 572 143 283 953 587 58 705 381 320 593 85 73
510 541 585 991 501 570 657 300 823 781 893 577 968 548 809 806 541 522 272 252
281 597 930 740 932 752 137 385 729 871 443 282 652 561 770 285 509 284 993 109
620 264 904 351 824 133 793 417 482 181 428 884 442 66 343 811 959 855 845 331
689 117 859 597 902 361 888 772 275 811 89 334 510 314 952 25 235 205 691 373
620 669 571 822 466 75 12 67 307 700 604 64 758 587 483 26 786 580 681 602
670 615 508 75 752 139 103 716 327 75 840 1000 988 550 838 445 299 871 267 617
769 852 49 732 25 168 563 600 854 360 558 408 430 673 610 231 243 260 895 706
120 611 755 141 393 510 110 834 492 246 891 698 277 944 547 178 550 928 67 299
55 256 560 27 12 840 645 424 383 319 228 111 93 567 341 716 983 172 888 152
532 440 683 912 786 665 784 11 66 56 840 489 777 966 640 715 142 687 771 921
128 935 963 539 822 103 168 861 773 48 406 753 838 491 313 509 834 58 960 242
497 781 610 783 285 106 916 834 131 113 595 772 728 160 370 734 16 739 681 895
360 698 299 88 325 223 217 888 106 10 95 156 610 79 828 263 227 395 688 324
961 188 324 698 8 501 801 477 439 65 7 867 307 990 418 822 282 659 533 934
605 222 729 690 497 196 18 369 345 446 192 458 357 918 895 243 952 659 240 128
