20
994 165 882 573 304 90 598 409 904 995 444 6 690 366 890 102 395 544 712 693
385 786 469 728 186 209 509 603 244 863 527 581 609 838 970 719 713 533 460 951
320 147 60 522 69 835 973 455 729 560 112 913 627 575 678 97 323 7 280 892
484 107 852 269 490 911 809 723 283 102 800 368 545 358 418 71 272 85 827 420
626 53 169 603 810 310 772 796 349 510 66 60 607 535 355 444 584 214 57 398
109 389 787 250 467 318 588 458 96 454 343 620 326 985 594 664 32 199 63 360
272 17 552 979 73 164 883 377 917 258 18 591 536 739 277 263 191 54 212 809
799 502 880 522 815 883 148 100 187 893 154 14 912 650 500 55 972 916 63 891
789 902 872 10 834 603 458 248 185 107 188 766 896 348 915 555 745 859 499 905
705 191 601 450 45 670 458 784 442 782 801 341 49 977 585 750 572 539 87 655
83 595 450 620 371 800 452 856 947 814 270 117 286 754 889 790 186 880 757 531
157 546 445 701 994 800 987 10 3 444 647 319 922 613 814 449 865 230 117 611
45 200 565 748 854 112 14 134 509 534 472 336 470 215 844 267 257 916 177 404
582 969 582 199 612 910 39 779 939 97 132 584 489 337 501 322 547 793 482 268
119 30 713 533 995 442 172 891 227 947 858 828 942 774 570 195 164 166 460 993
815 872 597 629 82 680 165 117 512 654 571 231 890 626 761 14 836 30 534 221
938 545 823 364 918 674 743 908 707 494 221 189 570 704 934 745 969 987 965 70
482 48 496 593 597 659 948 290 522 335 913 526 899 637 377 951 719 50 494 612
435 634 3 595 723 804 598 793 111 743 705 151 11 804 882 677 718 327 552 558
965 13 591 607 861 705 861 451 897 295 933 101 336 959 203 826 665 793 896 300
