20
584 408 14 419 89 359 421 704 666 315 270 88 829 731 118 753 17 917 750 95
679 405 718 464 586 448 969 522 196 861 28 523 869 738 198 449 192 879 687 722
659 417 560 624 75 91 493 74 679 3 15 791 731 738 815 691 118 143 543 178
950 163 90 225 647 175 530 976 320 265 621 960 706 447 27 255 650 137 695 669
556 319 126 768 736 929 721 866 263 594 280 589 792 658 562 139 530 655 621 296
852 62 127 232 434 891 719 760 311 559 5 608 918 314 703 750 252 966 988 415
577 3 307 889 725 358 211 703 444 796 314 669 679 185 831 405 339 112 199 917
439 977 725 56 983 662 992 899 797 479 380 59 428 652 441 146 46 969 941 513
955 39 131 734 273 390 127 122 420 676 27 781 926 152 234 660 897 210 617 720
922 838 669 912 45 391 814 364 444 344 643 614 571 152 649 9 462 969 295 858
432 915 714 173 286 376 68 854 646 15 33 932 953 37 42 729 311 963 17 667
54 750 579 276 147 8 973 532 149 360 125 193 362 379 290 546 522 828 31 214
490 214 741 133 238 832 46 580 520 493 535 372 613 816 128 400 224 471 490 172
574 929 866 706 23 29 931 862 167 504 44 968 345 783 164 365 433 164 853 953
396 480 280 597 809 301 539 818 706 350 475 185 969 306 983 658 253 104 762 617
140 68 511 823 991 273 522 238 69 42 995 364 312 492 83 16 86 535 380 160
317 890 110 39 599 710 807 869 439 389 312 637 417 732 842 165 264 170 455 526
513 43 552 195 787 306 286 848 981 591 998 405 243 117 872 898 526 598 149 449
860 105 276 661 985 946 489 687 149 49 585 176 362 449 362 603 902 806 914 793
344 237 588 361 340 429 324 700 236 596 920 70 896 444 287 77 458 782 555 649
