20
227 699 594 485 773 798 306 208 270 354 856 394 586 241 264 422 524 279 968 702
49 283 332 684 757 973 315 691 995 228 795 261 619 428 424 967 312 798 47 386
471 377 724 851 884 505 895 412 281 605 631 369 970 718 29 49 751 262 790 734
186 954 15 358 160 243 811 244 906 988 744 192 330 913 475 371 889 580 880 443
929 677 604 397 13 454 677 668 295 397 106 876 883 818 848 249 907 215 492 383
213 308 804 139 779 979 27 449 98 675 142 801 896 70 756 533 264 170 336 352
569 732 281 640 690 553 340 969 916 453 731 937 960 366 65 25 68 41 568 178
958 183 25 198 398 410 84 172 940 496 659 241 16 723 39 780 72 789 60 764
813 583 353 774 544 112 579 235 700 110 848 85 36 268 290 20 184 364 906 228
542 746 456 435 886 711 304 398 204 27 773 431 778 26 712 696 145 777 370 750
812 813 791 417 746 356 402 334 119 981 194 323 639 422 480 822 301 735 288 631
233 794 394 905 85 174 742 934 384 834 329 491 953 369 628 584 499 466 447 637
776 775 39 514 61 219 632 862 400 31 662 752 751 568 51 311 709 859 50 217
13 878 351 949 950 579 525 895 590 644 697 225 295 926 840 508 426 37 798 533
939 347 678 749 609 318 969 585 874 916 836 500 918 899 473 899 288 820 720 542
17 596 518 172 81 121 209 753 214 164 654 886 928 346 326 542 37 502 729 639
918 4 347 72 683 994 182 755 178 996 123 631 68 587 159 595 770 104 823 716
82 349 385 300 771 125 754 144 721 822 816 551 805 703 163 414 267 620 585 340
101 646 958 406 629 87 11 879 691 898 551 260 159 429 2 525 463 451 982 811
711 114 107 661 711 262 527 169 931 852 437 669 905 615 709 73 446 445 662 987
