20
336 654 511 260 864 261 346 619 352 846 255 500 154 156 856 886 434 474 223 316
811 122 204 897 333 191 488 373 331 549 678 142 474 390 254 718 601 90 842 746
504 767 897 461 181 256 277 317 623 461 661 723 304 556 506 446 347 732 405 321
549 803 250 238 936 969 117 699 415 607 478 338 68 894 696 212 350 380 922 127
959 20 175 435 81 223 656 901 594 441 221 774 749 65 823 970 487 983 356 384
653 336 776 874 474 603 820 537 340 870 790 844 566 334 933 973 223 296 955 231
826 710 618 451 633 882 492 258 406 712 417 776 176 378 871 883 16 784 524 616
689 391 322 888 25 583 483 793 773 197 689 497 318 826 279 528 423 109 205 821
631 127 749 248 358 627 828 100 432 368 446 97 851 765 384 310 665 84 962 133
147 528 653 418 571 992 106 142 1000 35 317 802 823 891 332 621 391 306 196 291
44 406 731 120 656 669 639 633 404 273 581 51 174 26 703 307 596 897 354 645
59 905 572 787 45 426 518 62 532 967 41 194 936 144 833 592 964 694 972 84
692 646 536 664 518 612 536 533 215 268 137 511 717 161 775 89 48 101 245 263
259 959 866 168 296 556 923 392 667 971 108 397 305 942 621 424 246 936 38 763
841 81 912 949 385 150 267 73 519 540 910 750 962 925 392 979 706 627 593 328
186 569 809 251 497 475 139 924 61 724 149 175 619 514 618 715 804 360 688 678
635 667 238 503 833 109 756 30 577 115 406 947 601 504 642 19 110 867 701 238
315 599 947 487 994 625 265 961 245 542 623 631 100 779 452 452 902 429 835 994
152 421 497 991 801 780 716 67 82 901 721 622 643 560 103 1 764 29 998 807
720 360 560 980 939 904 384 985 278 217 860 696 138 913 41 450 120 951 26 459
