20
425 707 506 245 64 205 751 758 697 183 239 125 686 954 325 592 153 97 962 963
475 32 744 834 323 335 355 367 614 150 593 412 668 717 158 156 114 84 694 245
426 921 557 694 827 913 648 498 360 407 279 478 430 948 507 638 310 112 306 999
10 160 367 999 599 468 829 230 939 901 1 35 729 174 846 172 555 25 225 243
965 615 533 311 652 327 560 879 107 366 823 4 459 720 728 781 271 801 770 403
942 133 765 208 798 267 174 551 916 582 965 592 915 382 924 510 733 44 792 969
422 866 494 573 221 507 730 662 853 518 940 304 437 480 538 19 778 194 803 617
359 321 773 991 98 740 55 24 398 450 937 657 690 832 654 207 436 670 842 226
589 436 531 18 873 149 203 615 686 849 875 306 986 724 641 106 509 630 262 163
530 107 446 564 72 538 34 305 784 792 371 330 732 10 153 443 885 20 481 228
369 319 255 48 117 396 244 241 399 995 341 676 933 186 938 286 687 823 652 312
522 661 23 683 756 292 168 430 784 35 97 737 771 6 592 374 567 781 955 258
203 937 578 811 335 649 355 208 562 1 675 74 100 59 617 301 334 691 11 865
587 804 432 533 63 3 325 256 567 615 507 139 421 131 984 257 376 595 673 59
538 904 577 412 759 836 136 769 109 316 971 445 848 868 211 781 8 791 844 870
652 95 129 403 606 501 225 610 232 5 756 923 704 943 372 810 914 285 705 22
835 467 819 961 818 138 906 555 685 402 812 730 173 119 847 197 376 14 480 991
594 847 630 159 421 965 584 694 205 607 88 978 277 862 928 778 987 198 938 567
348 44 309 638 305 734 891 639 979 637 905 607 211 177 751 616 573 508 18 246
718 289 147 963 743 135 968 776 1000 793 489 755 506 596 137 776 345 340 192 810
