20
703 978 93 873 613 947 522 265 791 750 11 293 152 654 544 54 464 205 197 693
839 62 293 519 111 980 396 584 836 849 363 44 348 61 137 228 722 973 97 387
805 324 798 191 555 385 330 279 776 610 609 166 54 23 86 432 775 628 980 34
198 90 664 325 593 861 645 469 943 301 503 733 610 974 295 821 590 636 330 251
679 695 441 24 189 26 273 993 507 646 449 577 995 792 911 382 29 573 31 72
981 727 219 161 54 284 869 89 216 443 132 527 338 460 187 935 484 525 572 476
519 548 80 943 235 158 259 162 163 510 798 428 634 864 687 997 776 15 302 384
645 744 934 457 663 280 624 768 381 562 946 436 929 15 338 668 330 108 687 396
693 377 828 45 593 671 829 912 354 967 613 781 391 304 975 687 80 72 462 710
875 150 284 533 191 697 40 646 326 526 985 273 296 899 387 193 256 292 907 766
485 521 113 756 553 723 842 805 443 555 864 71 41 302 882 389 869 126 899 140
981 450 288 623 837 975 262 192 270 460 636 618 374 74 525 287 678 289 545 825
247 257 361 458 542 440 160 86 151 664 526 454 441 596 269 575 304 694 528 493
59 8 86 236 46 154 467 923 656 860 117 898 592 225 993 376 141 994 732 390
877 116 880 51 6 600 5 862 825 946 729 284 809 693 927 817 211 635 259 55
495 580 647 173 72 683 820 659 556 652 178 204 995 835 872 587 289 199 732 341
659 463 699 1000 342 72 68 275 173 610 719 904 709 483 881 730 719 844 788 66
963 10 297 207 327 976 234 955 623 849 146 529 957 838 991 382 830 9 650 506
858 942 174 12 346 398 681 706 415 800 151 279 386 429 252 591 40 179 188 732
993 782 648 46 1000 986 836 633 332 962 535 573 315 647 134 714 654 818 170 323
