20
724 832 888 468 999 964 112 63 436 996 108 363 68 710 685 281 964 941 270 930
721 157 975 606 183 650 28 24 965 444 136 491 977 96 627 209 78 746 882 506
92 269 204 447 513 175 674 653 836 715 183 927 881 668 181 272 620 608 862 326
878 220 752 523 878 105 17 660 870 761 360 82 935 333 984 1000 98 332 939 996
859 568 229 405 236 871 545 651 108 606 841 172 805 880 581 460 313 475 130 709
609 782 560 396 865 120 605 664 753 866 373 138 237 657 699 521 101 541 972 417
392 999 638 771 500 90 927 219 616 84 827 490 809 564 126 364 923 825 996 409
204 899 566 85 653 347 109 579 923 491 632 572 957 644 934 374 258 272 527 682
300 913 419 807 556 66 34 67 210 207 979 142 168 984 821 292 911 674 663 733
492 755 591 53 777 701 524 417 89 516 489 34 218 504 348 938 971 709 858 844
162 581 556 642 181 656 26 144 763 29 634 905 37 919 932 694 855 559 696 201
539 303 527 513 273 706 254 615 698 648 447 666 854 13 365 531 328 585 146 494
410 791 370 381 119 381 666 777 970 39 404 993 10 32 96 591 764 875 891 303
236 817 798 758 153 721 692 54 816 956 526 869 491 879 429 866 49 441 84 618
438 37 812 315 103 136 330 467 735 140 131 210 963 40 818 899 483 565 998 610
930 690 716 139 398 2 645 448 917 808 960 844 878 986 927 710 599 55 618 85
356 531 324 466 914 14 40 235 606 928 173 904 287 189 924 505 172 404 999 29
113 365 936 676 427 368 95 95 532 682 568 560 24 257 538 411 121 996 729 727
758 180 654 143 963 675 386 89 972 400 911 758 668 73 470 841 571 841 605 322
788 32 844 160 326 879 967 82 859 79 120 51 795 269 292 582 174 20 201 861
