20
258 368 784 399 278 298 704 855 995 345 554 494 31 290 476 297 289 170 419 868
377 830 409 849 27 108 671 542 668 310 49 818 225 196 249 62 402 951 954 177
135 517 614 653 515 809 951 438 174 490 242 680 699 646 304 72 62 135 522 30
662 531 468 170 217 474 718 712 965 422 414 957 502 54 976 749 798 482 290 264
705 524 884 528 44 757 108 517 528 471 43 696 86 781 803 970 321 621 457 426
307 28 899 375 854 644 732 133 216 281 499 152 502 435 102 905 592 290 232 785
586 874 106 262 786 142 191 894 151 313 40 618 609 639 463 722 342 588 726 451
249 149 31 418 360 823 655 622 369 207 253 362 489 531 823 72 273 947 179 978
290 298 407 723 163 479 610 858 567 419 915 311 351 521 85 409 506 216 602 781
634 673 738 946 377 265 167 778 348 638 567 716 908 68 652 750 420 679 65 635
293 787 83 627 286 647 580 378 125 354 79 766 435 351 305 347 729 941 480 634
453 561 433 449 804 826 877 80 183 987 349 806 942 840 25 673 530 613 137 413
776 852 576 237 402 133 933 633 195 473 676 112 903 736 621 340 996 856 677 406
720 150 791 752 764 545 249 54 437 804 798 166 103 615 413 917 990 323 534 641
35 716 790 745 236 19 962 887 527 182 391 192 433 229 321 56 224 566 730 463
110 629 865 265 737 889 837 370 999 119 158 3 509 280 180 766 114 947 258 271
718 379 94 783 965 61 684 930 165 746 165 705 186 412 896 769 822 171 339 893
803 22 101 202 361 765 534 507 95 539 559 572 569 992 899 210 247 776 363 486
74 101 991 1000 575 461 535 958 613 639 652 668 641 218 238 177 164 754 886 748
830 970 228 193 934 337 878 546 548 854 734 670 265 279 341 738 141 216 339 650
