20
609 906 441 746 513 754 742 670 502 830 481 44 667 42 885 814 616 411 896 285
859 886 580 450 686 469 603 805 380 335 278 81 905 422 180 292 740 128 318 365
682 484 392 44 788 789 567 26 654 191 142 821 205 685 56 286 119 122 250 505
170 864 258 509 638 556 332 57 934 583 154 482 958 438 432 421 632 731 657 178
933 776 78 424 963 672 69 226 256 42 465 685 46 872 853 606 391 309 919 166
702 523 373 109 136 761 528 149 743 638 671 772 395 156 628 437 409 51 48 357
934 123 300 973 11 541 386 785 429 877 575 602 196 544 626 675 949 444 820 16
269 574 219 935 928 329 104 307 774 285 218 977 583 32 687 351 895 107 817 498
435 82 15 656 838 929 330 799 920 602 497 579 866 736 372 401 616 181 527 946
585 227 118 779 638 873 467 280 244 11 516 21 390 692 374 168 540 14 50 655
420 62 657 927 844 310 995 251 841 446 503 121 563 575 840 25 679 45 226 209
366 875 313 810 466 313 567 365 531 226 190 869 530 403 885 534 29 905 10 153
328 557 11 384 525 943 768 914 43 770 75 746 891 120 923 557 317 763 203 51
200 484 216 932 365 332 558 343 41 681 556 308 752 817 193 549 155 543 160 925
55 540 837 638 566 581 799 935 813 173 3 551 55 477 481 403 410 617 394 176
856 635 445 155 327 166 902 463 83 587 233 196 269 84 413 669 82 855 191 524
218 349 186 656 440 701 11 140 824 180 905 92 879 860 639 482 47 725 926 942
599 670 653 681 885 347 230 478 154 200 754 486 246 614 954 431 457 502 255 174
215 667 617 742 20 920 199 993 265 888 65 272 884 996 946 305 831 375 703 64
30 20 23 201 99 459 356 820 507 713 459 980 958 46 152 938 25 43 175 57
