20
943 523 126 47 94 454 198 682 204 639 69 848 468 828 339 894 43 964 34 11
655 283 677 287 135 942 354 411 730 931 54 813 325 765 867 761 363 874 572 298
498 255 953 83 414 793 845 301 185 757 137 607 458 407 917 584 698 152 786 110
674 672 287 123 208 795 897 851 183 279 395 299 968 755 356 478 626 315 422 508
771 227 393 757 861 684 129 343 134 71 20 947 993 18 333 634 81 367 908 556
250 957 730 974 439 332 934 915 529 550 1000 308 535 729 744 443 31 261 545 848
54 882 302 837 182 629 513 497 591 357 737 2 795 579 237 733 154 332 749 372
173 258 871 501 347 28 781 318 202 215 321 875 334 802 915 83 291 674 42 208
942 646 197 550 294 115 19 595 575 764 592 752 467 893 484 99 15 322 669 627
459 734 92 613 226 590 979 848 153 512 678 829 797 850 852 810 242 125 191 416
189 978 733 522 385 959 876 12 139 207 692 948 560 249 83 494 973 268 234 74
488 728 48 14 56 917 321 368 387 378 487 779 123 576 54 564 73 861 746 50
268 539 36 833 816 929 752 50 861 528 620 858 326 134 404 157 862 733 445 710
405 480 373 907 769 423 223 501 501 627 895 461 100 994 171 805 10 38 237 188
971 697 173 861 57 428 516 17 164 559 411 942 151 416 458 189 572 111 606 822
94 647 812 556 676 816 601 513 408 343 422 194 629 670 772 492 164 959 372 997
115 190 401 55 659 23 681 28 16 943 158 625 998 546 130 668 274 345 233 662
306 293 962 331 269 962 855 682 321 523 163 78 16 270 362 71 778 762 283 647
199 146 95 768 284 510 283 971 192 739 384 484 883 488 920 432 567 448 989 663
356 501 877 283 965 516 715 788 833 294 898 541 996 277 119 317 27 218 176 773
