20
961 422 583 174 690 792 993 666 5 418 184 207 993 86 183 929 468 876 326 553
262 809 605 550 392 351 585 986 465 70 448 967 265 555 183 458 37 422 99 496
308 523 711 533 682 751 696 307 341 317 129 149 251 808 127 985 772 435 307 817
157 8 858 14 790 541 265 335 375 318 887 668 509 299 755 752 566 688 75 529
438 779 184 703 736 823 799 174 977 740 571 632 777 786 158 451 468 544 332 120
725 739 796 400 624 17 22 613 912 986 706 871 235 57 727 97 226 132 329 723
52 689 828 376 217 558 381 207 743 99 46 717 701 378 392 316 100 430 259 648
220 795 860 972 311 382 840 398 377 809 377 183 913 842 658 90 353 899 143 921
472 165 267 877 422 861 66 166 700 324 854 107 342 498 748 14 947 437 938 206
443 624 76 603 224 142 207 991 886 610 508 580 337 413 444 525 521 901 419 318
538 311 459 14 62 973 696 821 600 540 207 471 900 76 310 580 49 963 152 480
422 951 137 253 129 186 985 160 191 14 344 550 413 584 638 352 169 907 302 605
55 310 492 422 653 245 695 387 612 488 268 136 395 60 610 351 641 217 326 331
79 716 148 565 956 627 127 121 584 936 765 131 383 345 269 349 403 82 22 25
57 963 472 229 486 520 94 219 246 420 697 91 517 13 105 417 800 501 323 235
160 429 128 717 586 562 814 857 322 545 651 701 649 216 763 458 67 71 209 56
262 914 562 92 898 677 269 837 991 729 83 547 635 489 128 585 632 221 357 687
584 327 988 963 451 546 655 280 151 928 973 186 65 69 935 817 670 281 422 102
946 577 543 6 293 604 604 882 685 668 653 894 448 111 109 545 946 642 887 215
529 356 805 467 394 884 261 239 482 180 759 433 80 772 909 658 3 40 294 650
