20
371 3 299 14 508 381 116 54 411 782 559 196 345 529 351 375 735 238 681 756
118 125 579 268 508 956 104 423 548 830 73 335 198 498 354 697 692 844 662 487
802 986 987 572 527 667 170 68 919 44 325 802 287 357 720 894 329 708 965 270
255 176 487 490 409 376 577 87 459 495 119 152 337 933 734 277 698 376 952 861
425 679 6 674 969 157 212 139 806 740 543 528 981 456 136 301 433 910 260 900
438 406 566 773 873 345 384 663 32 207 258 997 380 431 101 673 79 411 697 465
919 2 623 458 795 678 389 914 402 658 755 821 309 409 429 478 671 664 800 461
255 486 475 141 337 304 502 771 506 806 221 494 206 150 684 701 221 735 182 215
715 967 83 974 632 117 125 270 902 124 632 675 751 857 486 756 468 472 84 902
34 732 935 957 511 378 996 997 900 194 32 881 187 557 410 112 67 644 865 74
207 342 97 524 562 776 409 78 499 365 220 430 493 254 54 294 549 646 831 586
334 198 325 674 433 716 655 766 622 903 459 189 6 439 412 137 805 722 946 995
422 911 685 956 542 345 334 621 242 568 721 282 68 12 626 787 219 71 219 250
714 842 221 759 459 510 536 536 615 367 106 582 399 753 724 968 572 173 270 415
849 325 838 30 998 267 675 636 621 245 651 291 583 790 759 44 774 394 163 405
490 138 945 98 246 3 539 56 398 157 484 857 362 80 746 943 509 780 243 899
586 850 56 373 774 782 176 493 867 374 145 186 292 295 717 945 246 591 389 340
381 788 319 541 140 93 929 673 757 350 620 354 410 466 291 411 111 579 760 390
522 420 598 769 410 398 492 184 12 785 657 655 853 179 393 279 167 194 681 917
83 16 614 84 847 541 653 148 191 36 463 544 426 523 240 183 807 317 837 278
