20
401 413 524 99 264 784 621 365 101 849 168 325 709 540 901 201 404 750 509 282
470 839 537 950 381 825 89 614 562 524 665 272 458 800 974 48 48 178 931 165
319 464 253 319 677 905 616 836 46 910 279 490 467 957 991 508 818 924 982 446
633 424 53 739 400 682 458 920 827 35 805 692 254 537 963 562 335 868 429 601
210 905 32 254 982 45 567 960 439 671 180 656 20 628 970 289 240 567 621 451
720 63 704 662 918 822 447 672 745 182 666 106 570 570 849 504 979 653 386 847
194 121 211 404 705 411 856 764 569 38 542 501 627 576 994 208 731 448 241 672
610 180 89 476 357 586 373 932 885 158 719 528 70 914 316 699 474 115 16 708
479 9 867 265 603 877 149 421 145 453 213 757 200 41 950 453 400 68 528 16
698 691 471 560 136 330 499 98 976 42 264 741 507 904 637 255 822 474 991 689
475 716 721 220 289 268 839 422 716 612 206 455 452 625 866 160 198 903 210 829
224 285 770 813 349 510 742 983 631 406 261 970 963 479 104 644 200 535 636 926
396 157 978 982 39 188 449 91 912 759 264 261 948 631 737 936 255 34 273 133
175 247 688 433 872 364 875 210 135 773 738 556 189 83 902 704 424 572 479 50
537 20 101 949 975 546 75 41 767 858 658 303 833 945 945 352 419 668 81 340
646 363 891 296 27 602 137 114 238 899 900 307 32 466 648 476 918 227 227 388
540 240 389 718 269 218 920 854 654 700 9 205 890 137 137 630 225 442 632 503
935 142 14 945 790 496 453 759 608 218 797 89 749 249 925 50 60 479 820 187
173 481 517 549 443 100 395 264 266 95 898 982 819 209 975 911 564 968 895 182
6 143 186 500 525 502 541 7 80 754 463 160 621 575 585 316 993 741 714 309
