20
996 450 79 751 617 994 924 665 707 896 675 569 35 250 144 766 733 793 20 432
143 553 136 521 598 280 867 332 770 727 953 836 213 511 667 864 197 766 825 857
112 388 95 353 31 883 844 692 655 626 972 859 230 626 471 576 15 888 97 14
205 963 7 638 652 788 723 988 476 811 830 412 950 138 611 575 352 189 921 653
858 9 111 800 845 646 573 132 842 946 672 892 431 171 285 581 792 76 578 126
337 466 56 898 873 454 647 376 910 492 508 851 833 234 672 766 550 233 297 446
370 939 62 664 280 324 451 410 894 466 867 166 171 588 992 875 487 251 444 495
889 768 925 500 906 575 160 482 550 61 950 133 544 163 402 146 513 812 171 273
361 77 906 221 594 996 284 974 467 153 728 923 212 202 146 212 595 901 492 515
122 928 848 161 937 914 866 277 222 977 485 765 890 842 734 135 894 284 783 550
576 294 919 554 460 952 919 958 698 708 937 185 180 175 862 515 87 359 965 705
460 4 888 885 830 701 946 226 487 441 149 720 643 851 104 555 777 642 2 813
475 388 855 144 236 428 46 458 832 612 24 937 329 77 239 736 231 349 694 695
6 276 955 582 328 465 436 247 557 80 809 419 532 752 186 369 168 506 640 8
865 168 228 5 519 94 927 951 873 676 25 117 448 676 237 300 505 972 811 742
753 267 483 419 973 19 617 492 995 314 721 259 245 32 697 960 13 170 492 949
5 885 183 897 718 774 495 349 429 502 741 471 742 71 962 179 521 878 165 974
968 189 576 373 91 232 229 532 548 480 434 347 82 412 827 948 572 963 710 579
645 902 911 835 991 925 176 559 875 810 43 33 602 78 572 791 635 500 526 141
159 425 483 5 199 761 131 693 419 821 394 552 749 795 818 305 61 671 247 379
