20
496 529 257 827 687 233 197 488 615 855 754 5 158 321 120 32 145 115 979 600
102 673 20 551 293 300 830 187 887 765 337 889 844 87 559 271 947 813 67 309
837 339 691 62 271 571 278 875 24 911 829 638 797 134 215 928 527 240 871 472
957 666 633 457 282 366 876 945 962 833 274 7 754 163 301 561 332 510 948 171
171 572 622 617 981 189 367 853 203 695 689 370 828 534 803 49 148 455 144 520
512 52 815 602 211 628 925 775 545 60 660 26 712 709 860 922 53 985 552 68
163 709 141 93 244 991 645 384 85 9 117 288 426 451 140 870 115 112 365 31
128 71 202 262 219 535 423 106 33 106 116 188 195 944 860 736 9 425 818 607
76 221 222 537 707 526 203 361 77 974 98 947 64 579 637 605 815 47 584 482
66 610 20 151 975 981 499 218 926 770 810 343 981 486 587 546 875 905 714 260
291 555 105 749 968 679 211 798 411 779 371 321 901 656 788 775 778 22 935 994
929 81 472 267 940 151 371 985 871 425 891 40 511 158 675 306 336 869 545 972
411 78 930 853 577 244 625 344 476 913 861 41 832 740 925 589 743 353 709 773
482 374 551 40 283 558 155 375 688 936 710 387 816 97 991 77 707 466 682 376
736 887 325 771 531 528 853 566 589 341 593 862 310 302 751 251 61 740 486 271
933 14 341 744 482 745 790 24 676 853 235 57 300 97 96 676 542 516 825 995
330 143 462 12 199 16 212 895 764 205 333 449 461 748 599 486 730 288 287 429
431 287 913 4 594 301 956 341 928 499 839 199 201 759 356 861 490 431 191 849
269 420 988 412 645 999 90 373 192 405 971 212 177 435 167 7 87 710 665 621
673 334 116 654 71 852 795 203 875 255 652 75 770 590 980 839 457 516 843 109
