20
871 646 627 646 922 31 762 112 364 675 123 889 526 533 885 217 384 812 118 477
737 298 271 579 674 227 63 650 343 298 552 446 857 771 629 303 574 566 974 521
975 825 8 470 435 105 884 409 954 347 497 146 766 284 229 646 844 696 530 423
631 653 34 619 91 311 978 599 715 215 779 529 30 399 365 531 418 924 46 18
638 946 227 723 314 642 581 177 296 659 470 710 387 995 280 955 35 456 4 967
656 280 931 474 620 598 793 655 177 959 928 783 281 870 120 27 50 439 187 981
77 137 133 406 360 832 327 649 95 982 544 123 884 594 259 652 785 532 881 902
173 636 877 85 421 263 490 409 367 244 542 775 224 170 723 822 962 802 133 862
256 113 846 37 216 249 136 982 780 317 360 913 153 683 884 265 280 847 383 250
659 92 468 312 59 192 448 658 556 439 289 508 612 426 606 191 589 56 688 662
354 577 746 398 944 154 39 706 72 370 920 926 551 368 367 369 213 218 124 976
180 316 401 622 364 986 529 886 168 318 877 572 746 313 368 534 472 962 578 532
667 668 762 914 747 608 766 923 396 891 563 787 844 22 898 572 377 990 893 329
843 666 669 321 108 264 979 507 873 623 493 780 289 916 783 155 580 725 647 922
412 45 441 102 111 473 457 574 576 969 464 625 534 789 195 79 167 23 975 542
157 642 384 147 794 843 327 860 211 527 449 525 576 711 369 575 9 501 944 524
478 607 52 336 563 104 163 625 255 85 500 790 155 828 397 703 718 227 12 930
151 384 962 596 818 6 592 922 197 944 878 715 306 105 811 131 530 935 539 864
377 63 775 167 43 45 781 199 982 149 372 350 549 55 144 687 693 770 572 119
818 321 596 82 29 337 291 651 951 856 30 248 68 559 862 766 98 9 518 651
