20
150 130 128 757 555 5 521 405 729 954 180 256 148 804 762 803 629 845 907 149
751 280 65 361 999 426 540 731 684 218 496 262 162 787 26 915 34 749 819 867
918 494 682 793 89 870 533 932 872 228 684 148 412 113 624 45 163 867 191 164
960 934 422 478 415 636 849 452 848 770 954 150 866 941 331 791 644 412 783 470
8 929 498 140 326 102 899 583 471 608 690 406 962 745 943 263 417 940 222 945
341 446 860 367 138 185 472 858 459 336 572 381 825 900 557 59 489 201 696 44
902 909 505 545 554 439 926 904 233 285 568 202 394 610 115 272 869 204 851 204
31 419 850 157 766 244 233 795 807 261 850 54 11 451 839 236 145 658 252 861
120 528 341 436 225 682 785 167 393 871 1 220 825 650 409 720 900 801 916 754
138 675 948 429 461 128 546 613 899 531 947 527 175 351 498 152 19 781 845 514
760 290 326 272 512 123 984 376 244 316 175 603 619 604 326 862 846 673 920 236
170 422 880 713 816 796 71 227 787 434 455 437 431 47 24 280 497 484 766 13
963 417 558 195 734 679 836 923 931 738 135 543 95 97 106 311 35 797 347 560
196 580 290 270 402 40 677 964 554 448 771 730 179 206 365 214 36 744 962 82
857 732 603 798 921 796 230 880 326 212 965 762 458 775 164 881 609 975 481 698
173 869 658 844 129 802 629 237 261 76 956 763 230 657 247 349 527 820 523 710
858 481 846 116 878 438 679 646 134 528 464 243 116 572 497 896 632 366 838 780
851 648 465 997 467 263 85 354 631 8 62 528 445 822 953 435 304 591 630 938
107 909 16 406 731 300 807 30 138 938 719 108 186 627 749 347 772 966 109 494
27 788 76 817 120 824 582 601 48 614 441 907 796 545 882 251 823 300 764 213
