20
937 379 37 161 833 648 813 541 749 715 91 323 992 769 197 966 327 414 613 317
138 980 110 767 492 586 796 278 43 288 71 263 813 326 835 166 37 873 870 558
846 339 83 440 618 26 190 487 918 86 778 803 360 389 258 377 887 947 923 101
105 60 155 297 622 376 926 126 195 806 58 377 880 870 592 331 787 472 1000 605
601 736 638 285 634 812 348 600 940 22 475 653 739 972 163 272 929 508 881 939
568 686 798 223 690 851 728 626 259 821 111 554 855 471 911 946 479 939 74 638
12 986 971 580 247 738 46 182 967 235 56 582 309 653 636 746 303 807 211 927
672 908 287 598 423 378 434 172 847 542 736 697 394 984 770 235 255 199 764 500
886 25 981 62 576 990 469 891 777 912 565 280 950 64 801 153 98 672 12 555
307 91 9 96 705 185 523 901 325 62 5 165 906 2 21 336 211 926 674 765
971 232 76 122 586 608 321 144 152 482 630 409 750 249 848 947 372 957 794 228
382 984 452 456 962 98 295 142 947 130 685 215 860 65 980 83 582 307 150 875
359 263 601 218 520 310 546 955 922 20 881 959 141 788 106 601 665 206 988 288
933 844 54 388 697 884 8 288 840 385 26 893 951 361 475 173 249 249 37 389
779 493 545 914 797 481 412 863 309 107 919 580 72 97 283 220 911 476 577 884
948 50 429 28 58 900 769 865 829 437 809 226 102 619 639 127 436 511 137 90
594 726 38 711 496 209 151 44 624 58 877 259 359 419 465 343 749 707 370 518
255 422 980 619 148 785 351 908 346 883 16 559 843 739 764 580 299 949 997 160
134 897 58 659 662 387 25 141 703 434 354 656 818 286 468 634 759 282 514 108
266 139 481 152 78 289 247 526 881 665 746 38 812 184 952 627 783 462 750 236
