20
181 698 999 606 841 38 679 177 154 278 840 625 276 523 274 21 11 448 266 669
378 272 927 86 491 99 437 373 739 536 972 491 929 765 860 4 343 160 888 151
306 817 38 805 301 126 446 757 725 162 335 354 410 869 475 916 44 785 242 570
992 238 921 708 817 401 128 297 15 499 305 256 786 15 572 251 790 403 45 792
385 441 450 597 908 545 988 429 686 985 218 299 964 50 911 72 512 932 728 284
618 338 431 722 498 532 664 69 137 107 49 94 854 200 633 830 178 533 142 735
179 673 683 769 897 224 920 855 212 214 477 111 993 322 785 957 169 192 631 988
217 532 87 256 643 209 875 408 479 861 431 671 319 790 868 125 648 81 397 750
773 190 925 319 734 852 150 256 388 364 888 461 423 302 66 813 626 676 304 183
593 729 629 759 831 365 178 667 14 589 275 911 112 494 609 88 127 579 135 625
896 878 710 377 595 467 139 431 482 619 578 414 127 807 472 500 475 288 948 848
949 625 706 717 943 768 902 169 685 590 493 943 467 831 201 725 692 342 978 221
800 331 897 394 85 165 44 75 539 433 343 499 994 155 538 238 736 122 75 512
552 432 513 678 696 53 891 926 446 489 132 290 619 78 536 351 537 526 30 719
297 405 780 135 46 311 317 220 311 850 525 202 838 899 514 458 321 710 873 559
328 290 234 864 36 859 143 910 966 21 706 878 949 689 984 837 967 403 552 933
117 940 840 899 809 322 835 513 762 268 685 916 784 732 415 747 879 378 385 6
940 363 466 169 350 528 835 775 869 449 509 860 152 152 385 953 915 329 760 809
24 65 74 291 792 499 594 990 895 880 463 342 352 802 774 418 902 408 546 861
198 609 939 783 258 487 437 511 973 37 748 386 251 683 439 12 796 343 62 555
