20
514 307 126 445 384 119 10 589 466 718 246 146 953 980 45 467 396 715 536 443
510 509 145 503 722 869 19 163 735 936 99 272 769 255 425 17 697 926 82 943
957 741 204 320 793 89 608 690 350 616 909 803 10 253 286 328 755 167 629 943
864 462 689 550 681 376 946 836 62 659 582 516 203 258 514 325 260 657 427 739
511 71 865 57 187 332 152 801 252 597 414 419 750 268 149 932 751 780 18 460
890 283 554 531 929 817 196 334 636 1000 664 369 186 887 429 832 998 314 923 924
833 857 956 630 677 288 900 971 573 926 466 633 124 81 206 870 77 68 183 767
312 895 377 286 742 481 768 498 490 402 496 128 290 205 63 602 774 35 938 466
181 928 181 693 288 851 600 278 216 723 790 164 207 981 615 407 472 279 775 919
26 730 813 879 735 151 323 108 638 39 655 774 784 871 649 963 155 118 336 588
722 283 749 684 189 179 999 350 154 257 940 945 85 858 331 777 612 837 834 175
408 526 925 18 234 993 769 259 303 221 365 482 598 829 52 439 972 990 159 652
133 477 304 607 75 477 578 1 68 688 410 350 566 868 306 934 707 333 995 14
289 219 734 666 35 442 987 836 297 589 814 168 347 945 325 922 269 452 245 277
703 568 374 799 847 3 245 745 140 243 707 39 691 884 707 359 967 950 529 163
533 790 706 976 719 905 987 763 573 566 192 781 271 736 913 767 982 114 30 79
683 944 860 532 627 277 549 800 240 939 787 914 700 49 948 624 430 147 727 605
667 776 323 466 85 514 356 504 625 823 362 357 308 474 503 298 180 20 786 700
109 134 249 613 421 201 597 846 799 468 284 856 243 775 510 651 988 245 349 612
583 199 967 26 761 324 973 944 879 304 5 517 833 852 941 588 453 701 168 810
