20
373 903 98 666 644 208 206 359 700 250 794 120 243 674 263 701 849 46 264 499
258 588 927 132 430 118 405 422 466 633 524 876 324 486 872 597 643 260 956 241
533 692 434 549 732 337 497 78 289 277 332 363 108 428 620 184 402 128 465 430
113 242 636 281 71 618 121 749 239 912 389 74 809 246 255 403 838 981 929 182
963 739 740 51 333 528 665 137 298 588 905 167 376 348 990 501 984 228 831 610
313 424 237 412 379 641 943 208 95 573 698 970 21 472 760 234 64 903 355 600
280 837 898 158 388 751 438 206 447 682 352 809 768 936 897 978 130 567 685 434
732 990 419 548 17 835 926 661 851 722 563 751 876 523 770 951 197 451 366 438
163 127 471 113 778 73 949 789 777 274 276 510 812 176 194 810 615 518 402 627
748 119 867 194 138 358 986 439 547 470 961 915 988 510 348 692 516 871 111 876
67 104 423 682 782 126 391 666 167 122 820 585 549 196 618 222 41 5 886 268
774 576 915 97 195 857 498 191 778 443 388 394 589 491 912 660 935 434 978 474
699 923 389 509 921 586 285 63 969 642 509 482 993 556 951 75 186 570 382 241
494 157 538 904 611 865 945 669 865 821 254 921 743 829 83 437 231 215 556 153
953 710 210 187 115 191 915 790 483 142 690 16 858 279 770 422 602 445 733 697
152 967 65 241 741 385 711 7 503 262 719 471 713 868 620 727 459 953 678 210
792 436 427 213 216 677 524 374 409 801 497 552 80 490 962 853 434 859 705 107
361 175 733 610 182 324 729 709 622 385 840 903 886 719 944 885 928 258 675 104
930 212 798 342 913 759 11 982 717 953 831 680 417 952 307 373 197 385 654 643
325 517 606 712 438 330 804 258 480 174 851 674 158 979 810 440 840 653 156 701
