20
574 169 837 119 24 257 475 750 766 137 546 186 328 162 993 652 186 350 999 865
190 451 448 796 265 627 817 785 631 894 454 867 239 680 735 373 198 285 306 672
432 537 746 855 398 893 830 199 496 42 513 181 967 405 843 85 446 495 876 543
946 141 218 280 915 472 366 196 361 519 129 709 223 11 586 610 663 468 627 998
510 21 410 359 25 314 24 401 526 914 195 819 431 498 228 546 492 620 557 972
865 99 523 42 612 525 245 119 690 313 73 68 876 902 597 792 270 920 204 683
564 776 56 207 167 4 563 430 602 563 293 26 285 921 733 275 218 258 275 443
172 776 747 286 190 153 535 866 812 67 934 592 916 683 269 7 528 292 469 422
886 455 641 688 413 699 220 882 419 82 85 204 679 804 183 960 839 621 436 757
598 393 899 174 145 756 665 994 194 26 144 909 798 68 998 513 719 771 489 194
551 229 953 52 911 532 886 206 828 407 120 287 127 736 564 219 466 674 879 252
64 998 407 689 589 584 795 876 999 330 973 510 177 962 197 856 211 649 401 629
422 465 205 761 612 540 896 192 770 614 885 174 891 584 533 603 272 569 580 462
171 48 821 135 69 253 94 804 558 730 311 342 918 781 947 267 895 801 750 693
846 98 255 718 803 296 772 765 8 888 590 397 438 244 11 772 23 644 632 512
934 251 424 447 969 918 313 550 273 52 405 913 465 524 589 887 7 456 708 680
816 465 848 565 243 304 687 849 604 19 145 327 811 903 124 70 340 326 908 268
206 729 603 275 665 990 337 400 82 728 507 154 638 49 407 707 979 207 542 224
192 158 825 299 239 977 478 907 202 723 277 871 669 770 946 405 570 6 332 844
860 408 872 296 114 525 567 763 592 149 249 679 465 302 478 74 983 265 588 120
