20
181 95 221 278 534 688 256 853 690 235 339 727 763 24 296 648 825 573 754 413
447 878 940 9 131 26 709 377 156 824 962 784 101 599 64 254 547 945 727 576
637 132 718 472 166 527 577 364 267 260 317 958 699 390 342 538 727 864 509 706
386 792 690 414 3 803 307 628 30 505 22 860 20 436 500 46 413 847 988 87
440 56 485 347 683 152 695 959 465 942 820 128 519 745 473 2 28 685 255 272
820 239 172 733 180 125 968 647 600 521 87 674 704 692 531 62 942 278 388 349
61 864 35 945 668 418 859 665 187 804 72 296 693 224 458 446 799 535 868 410
409 357 772 966 465 520 664 803 300 673 610 26 460 271 520 433 691 539 679 806
443 962 28 95 637 569 739 55 382 508 100 499 741 34 749 805 717 439 163 313
934 760 771 202 277 765 289 193 443 335 558 379 391 753 720 217 89 997 810 939
422 588 56 990 754 602 564 922 830 796 551 848 905 745 25 398 394 384 392 465
271 197 525 132 807 177 263 231 828 959 701 89 289 788 481 685 607 676 333 917
516 760 755 829 131 648 800 162 367 567 697 667 561 161 224 767 478 876 627 460
330 732 790 363 399 276 68 655 639 234 755 652 31 775 715 783 704 767 188 560
135 434 273 803 826 868 887 682 429 506 735 236 746 361 268 671 177 227 108 904
950 119 717 867 795 261 60 693 403 476 174 113 474 868 701 690 914 874 171 461
778 50 484 724 401 158 938 255 805 628 386 401 289 343 975 779 56 767 155 139
479 539 171 75 900 175 14 958 318 841 449 29 170 496 275 263 352 109 974 157
424 441 385 115 716 975 306 83 888 541 846 871 574 410 720 205 153 905 216 778
128 282 439 437 102 878 865 804 293 79 566 105 975 577 122 663 920 877 125 559
