20
935 563 130 53 115 556 907 880 325 448 578 191 719 571 538 461 992 861 435 633
677 465 533 669 562 932 436 651 636 619 113 295 599 701 443 828 968 467 506 417
129 91 881 905 2 431 62 793 176 567 10 384 200 409 712 644 195 641 323 231
409 619 972 365 821 66 193 725 362 234 166 949 187 603 206 93 461 271 971 785
492 873 999 347 946 298 853 74 570 674 362 866 378 351 102 677 547 171 523 543
294 810 609 69 288 208 704 465 242 1 404 722 640 759 94 734 904 569 810 724
123 833 624 130 976 305 616 645 147 516 677 48 910 390 892 447 60 364 282 189
793 517 281 367 76 170 743 592 511 162 947 768 959 634 649 122 535 765 338 124
573 804 477 672 773 200 614 718 367 986 142 717 123 597 951 693 397 544 823 126
181 609 637 318 862 973 735 794 943 382 31 87 652 624 423 593 740 353 215 363
220 874 618 196 948 822 674 820 278 502 296 523 835 162 562 793 981 736 481 113
124 942 334 784 356 926 559 599 63 102 909 664 946 922 507 303 939 778 263 605
227 308 738 704 628 108 197 257 442 677 171 656 22 156 575 663 315 714 594 516
256 681 174 185 485 102 691 933 195 80 513 921 849 843 189 311 620 612 991 879
247 162 543 578 114 586 552 13 301 763 464 755 611 624 13 729 451 700 73 285
903 185 810 42 617 815 22 589 676 64 187 776 212 118 295 89 480 840 415 101
906 241 932 390 756 197 91 49 336 975 981 901 591 320 880 593 6 929 558 236
691 992 713 628 211 239 781 790 678 679 197 343 11 610 152 210 175 370 731 269
248 187 137 649 812 559 100 273 970 770 4 395 597 779 415 999 827 465 272 795
607 1 925 138 882 195 432 7 433 597 514 116 955 565 686 392 281 825 309 309
