20
349 658 137 40 913 175 197 534 321 714 204 477 799 580 273 794 844 972 578 856
312 503 282 52 989 386 319 288 444 60 406 747 804 256 77 139 557 463 944 876
511 292 67 846 100 908 862 49 81 489 68 956 377 148 126 969 416 344 350 873
126 133 177 288 772 694 841 754 388 85 519 352 784 597 622 171 8 376 938 501
619 574 511 927 956 645 807 140 666 263 620 749 536 654 273 339 245 665 59 745
866 301 101 981 982 773 246 813 550 46 952 932 958 56 288 685 286 12 488 245
734 436 20 829 616 691 935 604 555 99 124 741 985 941 24 495 824 136 363 431
469 709 702 903 130 21 773 262 631 329 745 180 678 741 271 342 986 970 102 327
96 526 122 631 530 291 356 615 846 191 922 159 971 579 510 818 878 81 976 673
997 210 776 135 710 848 605 391 862 964 146 742 830 247 533 506 155 702 604 1000
111 992 849 92 415 694 884 513 258 78 783 296 335 860 709 804 420 249 770 92
943 518 371 225 89 402 389 521 242 110 389 384 468 955 247 885 802 843 842 384
451 630 514 402 676 514 89 264 254 392 218 427 34 173 765 619 28 624 90 524
608 619 355 294 779 128 424 381 874 827 716 280 649 585 973 570 57 554 870 507
404 675 375 92 160 785 11 362 24 292 5 680 602 28 276 349 896 862 707 640
122 377 272 445 689 390 752 669 554 934 410 496 334 867 675 236 168 381 81 565
698 906 807 507 405 916 272 691 703 598 458 266 643 765 808 696 486 992 770 728
59 180 39 166 251 888 474 763 65 809 813 286 236 109 96 782 355 386 169 921
72 930 905 166 524 693 412 147 147 982 280 795 529 64 186 423 284 496 183 177
647 353 875 172 864 649 572 261 445 388 167 738 538 570 748 874 830 520 878 392
