20
321 400 244 948 510 890 396 557 18 898 658 371 261 891 672 978 784 397 442 434
960 137 520 877 333 923 521 378 696 134 506 361 426 765 368 453 656 245 959 807
943 707 687 724 864 150 499 980 129 865 377 699 66 372 822 99 797 324 462 193
249 375 13 35 582 550 699 983 91 483 767 783 390 112 975 467 648 369 152 359
524 498 96 61 695 23 675 504 255 571 88 910 247 840 171 775 924 827 888 677
938 970 595 395 645 482 56 84 501 654 91 668 447 809 893 65 923 507 746 109
205 506 186 867 912 655 542 573 812 544 655 334 524 362 505 758 53 227 735 617
928 985 397 12 455 114 865 350 515 320 382 609 470 930 36 846 460 541 620 262
434 867 944 829 162 442 174 626 487 385 735 800 199 618 191 624 110 921 541 442
655 840 835 996 109 637 539 652 533 76 143 963 476 178 589 203 908 505 239 394
253 666 925 34 883 846 724 421 556 1000 91 600 251 248 816 693 535 859 521 49
516 362 884 554 812 200 528 825 695 348 504 29 224 575 490 419 331 330 92 832
376 15 109 549 375 856 719 683 299 779 790 62 79 348 532 321 391 39 100 290
325 962 386 822 200 65 576 328 735 272 894 740 945 667 856 203 277 690 242 170
946 225 838 945 128 778 579 4 615 569 834 753 317 166 565 304 270 844 467 55
558 927 792 272 126 96 579 42 127 926 504 177 403 921 482 96 111 743 37 885
802 343 115 143 488 261 444 326 806 535 533 107 232 320 465 179 604 51 531 369
239 439 194 813 574 724 71 783 846 249 936 102 873 624 791 17 409 693 840 666
50 95 830 370 893 806 855 727 467 253 149 202 868 444 439 322 697 120 261 314
943 592 620 842 880 456 969 606 118 588 123 81 437 438 278 1 813 466 994 172
