20
666 723 179 259 322 200 105 476 136 343 874 772 296 20 793 177 74 346 964 384
967 750 699 653 660 387 784 8 986 854 387 667 959 805 167 274 384 54 510 243
76 478 662 450 492 322 309 468 537 749 914 696 376 832 326 794 190 268 820 406
934 128 468 112 448 767 827 192 865 373 309 581 233 533 478 555 987 612 639 968
918 628 582 21 449 82 262 608 340 848 523 369 851 570 406 786 115 297 923 368
430 409 856 865 719 526 900 603 520 139 333 790 301 424 638 329 540 467 189 974
297 39 616 641 44 889 575 617 319 629 288 376 408 188 374 529 453 117 83 212
859 132 238 93 20 689 713 290 657 847 608 12 774 699 974 362 392 683 631 138
400 117 95 437 169 311 675 264 583 450 639 647 729 656 618 792 543 657 552 747
874 966 822 421 726 7 367 721 699 789 626 259 995 74 827 67 481 258 581 780
53 47 507 368 916 853 502 591 332 781 937 56 630 370 751 113 639 960 882 319
899 104 724 219 884 719 495 654 176 155 552 361 642 267 501 984 376 289 59 671
243 914 766 684 572 487 711 957 383 173 340 116 230 196 573 902 895 166 827 745
912 24 541 930 519 212 353 876 667 555 605 49 471 847 374 576 91 478 306 519
57 157 707 353 305 851 643 685 165 989 140 240 179 144 647 368 699 608 632 728
475 882 686 650 749 8 903 675 742 256 195 37 60 700 478 418 789 12 149 16
131 999 15 950 225 433 87 896 814 958 749 723 579 32 943 391 549 498 930 684
588 707 47 678 744 791 75 963 241 117 247 431 278 942 342 139 774 505 86 3
853 231 856 454 526 125 274 281 613 149 583 945 999 954 472 892 997 83 851 434
526 599 617 187 362 308 403 710 351 346 610 157 942 856 905 335 495 472 340 481
