20
541 708 94 783 47 298 317 530 140 646 472 890 957 271 857 143 350 131 680 384
314 969 264 692 614 590 827 146 26 175 100 406 299 479 354 984 789 801 660 374
229 685 234 382 479 5 849 484 359 989 518 287 998 861 128 818 525 407 406 18
325 131 269 927 322 568 1 326 216 62 686 84 368 89 394 707 49 993 759 431
62 809 311 18 161 129 345 366 235 435 275 640 29 479 453 494 96 435 537 546
404 538 706 238 861 182 367 251 448 732 213 952 395 146 692 398 247 620 860 393
989 361 836 144 948 200 6 59 190 62 917 980 873 571 916 653 101 812 189 962
363 41 440 204 460 60 574 619 9 816 587 669 847 216 778 728 218 166 805 860
273 8 354 440 56 224 772 596 922 597 12 629 820 672 958 696 163 838 158 461
803 423 647 599 39 390 1 994 854 946 93 318 730 888 524 89 49 281 260 338
58 358 120 335 610 293 969 76 633 346 536 19 408 533 481 799 199 758 234 112
208 413 716 149 922 855 919 972 373 48 982 375 318 550 759 188 247 979 791 161
914 331 329 366 990 106 189 4 747 870 978 799 60 871 461 437 458 760 356 301
407 291 50 364 929 46 377 2 352 106 381 914 207 167 481 183 102 646 54 167
403 835 705 915 712 551 251 320 240 413 992 251 22 229 320 800 91 487 445 268
209 969 961 973 804 675 519 877 817 915 308 14 382 19 950 322 197 188 623 363
315 26 136 893 461 130 594 585 713 590 10 175 199 316 672 51 93 136 697 329
921 500 502 861 774 388 292 607 824 144 312 989 57 926 548 756 141 572 544 732
32 819 322 87 191 932 536 142 350 245 630 776 182 13 669 557 527 249 666 559
728 995 648 107 927 91 638 950 523 594 611 199 587 888 181 563 329 911 827 206
