20
530 344 787 794 309 764 848 203 647 233 676 155 706 440 838 280 719 894 292 568
6 262 654 705 948 274 326 349 921 117 287 671 728 527 144 376 311 543 169 412
277 910 902 393 143 731 311 836 880 834 994 111 607 226 432 971 225 627 200 101
441 309 719 406 842 504 138 106 957 133 75 650 243 430 280 961 959 445 634 834
295 544 773 83 666 979 647 177 613 939 214 705 5 706 863 328 603 307 888 756
89 81 842 901 712 917 333 554 794 907 261 13 445 576 647 654 312 638 349 533
681 568 666 281 625 148 508 478 84 848 449 900 665 155 588 633 652 491 993 302
29 278 679 736 867 353 871 401 129 550 184 661 459 739 573 740 847 405 646 281
459 401 488 617 148 106 905 504 283 552 415 830 190 440 611 417 623 633 49 603
861 538 8 490 64 470 243 793 64 86 162 658 718 36 529 176 522 435 885 169
208 598 419 141 111 11 208 394 514 639 639 61 235 764 876 368 676 820 152 604
529 664 754 530 325 880 863 123 245 998 255 548 787 542 902 789 867 781 890 27
24 768 505 603 27 811 662 844 171 7 711 665 65 516 817 321 347 167 771 1000
483 271 28 463 866 851 232 873 158 517 239 883 178 255 570 963 275 896 419 153
611 365 590 73 16 901 487 913 510 258 838 946 299 847 255 778 488 748 370 607
698 410 209 65 583 610 840 681 506 952 831 653 70 406 154 734 663 610 626 845
549 823 81 145 397 81 296 653 309 932 994 192 405 548 323 626 259 249 333 961
44 323 749 486 77 772 610 775 188 846 1 211 938 681 397 111 367 490 632 76
214 805 131 198 127 764 883 803 886 793 909 757 660 639 485 333 944 412 895 375
866 848 615 751 739 931 269 97 435 160 1000 833 747 879 704 237 580 511 154 692
