20
966 193 554 417 273 228 777 929 956 101 756 368 509 339 687 764 762 351 435 471
862 739 62 835 478 632 475 915 669 931 667 272 66 272 411 2 559 734 89 738
182 23 69 355 181 903 929 618 686 400 592 626 901 79 135 214 852 844 800 136
273 539 74 478 769 988 176 52 708 512 207 576 579 474 574 680 462 187 243 510
763 22 77 272 732 592 166 662 134 875 765 960 806 834 836 397 262 383 1 113
940 689 522 446 795 83 962 567 988 7 574 168 112 821 781 70 448 68 129 852
379 341 633 107 963 206 127 187 576 671 523 105 490 432 946 449 963 475 722 468
599 852 833 158 980 936 579 973 191 658 954 585 916 422 89 236 810 154 389 104
772 959 862 261 580 796 139 848 952 562 218 309 170 254 856 383 748 155 5 930
374 114 586 443 424 378 826 417 535 406 370 485 696 77 571 116 695 175 768 813
51 795 472 130 687 886 592 640 782 46 988 511 441 976 110 958 17 326 824 823
786 992 312 485 283 530 841 820 14 746 873 716 377 615 738 447 565 785 126 280
374 809 873 989 141 582 730 793 958 328 375 794 605 497 810 586 169 40 240 204
127 976 931 331 552 548 62 866 854 691 355 345 993 216 251 343 721 876 58 193
447 94 140 829 855 104 473 84 417 310 829 643 591 229 846 725 334 527 482 247
999 454 278 846 478 659 134 164 60 311 118 577 890 506 681 184 729 277 815 390
860 588 935 909 734 98 660 91 396 547 841 900 348 515 19 161 527 12 429 460
660 600 909 609 709 226 612 147 646 637 96 94 247 899 856 236 974 478 332 183
612 595 588 198 931 405 830 165 130 248 92 674 204 684 968 546 584 313 582 105
565 388 853 970 503 28 836 738 796 254 878 644 797 770 788 88 905 952 662 384
