20
813 429 511 549 801 296 605 545 677 894 938 148 929 372 676 39 48 850 489 917
241 265 718 118 602 798 852 534 19 365 224 123 959 448 442 402 715 837 369 603
45 980 744 499 992 436 463 811 862 434 800 805 513 855 239 462 211 319 473 58
472 130 654 474 337 351 231 843 260 516 542 706 107 464 993 819 698 90 634 598
389 668 44 382 781 740 745 197 535 350 342 566 319 57 30 890 629 532 429 223
68 641 102 573 877 679 291 967 14 815 420 600 484 968 649 813 797 412 913 35
582 594 967 688 351 950 228 530 249 731 820 654 523 503 334 725 615 172 110 171
885 453 46 260 414 651 2 981 661 19 898 870 151 867 511 950 549 834 534 684
851 546 21 99 809 36 386 77 259 984 803 691 336 206 768 802 875 567 492 511
729 968 862 781 537 673 726 437 603 514 259 268 838 982 491 405 388 442 808 450
85 604 223 451 215 208 451 681 90 133 296 956 34 322 1000 184 105 582 259 367
532 326 39 222 677 796 711 518 997 148 478 443 933 348 552 280 330 249 49 225
726 810 235 896 198 390 301 243 299 16 832 136 724 672 749 900 349 221 667 366
1 992 569 493 776 641 72 760 656 436 512 906 213 280 599 701 519 56 863 704
258 949 930 177 430 294 466 105 262 759 94 358 135 454 656 254 398 819 427 857
737 568 740 736 472 806 770 701 491 652 61 26 477 184 36 721 425 491 12 433
787 146 661 47 789 385 552 891 896 716 764 370 599 519 97 759 472 465 373 451
140 609 564 622 516 229 542 21 230 601 618 734 708 458 998 129 731 221 286 336
104 135 779 447 818 633 149 599 812 160 567 505 264 321 606 9 760 957 941 785
731 219 104 627 620 738 77 688 406 883 74 111 872 538 991 914 859 369 111 471
