20
501 19 870 956 494 73 5 512 867 699 726 706 257 25 42 690 883 596 790 435
127 829 262 19 587 315 475 965 89 346 74 687 33 380 62 904 78 57 893 988
380 163 616 982 94 49 94 856 847 538 755 946 974 58 255 924 419 189 420 118
145 240 836 190 711 856 953 551 938 325 560 997 172 956 732 185 197 78 754 789
774 873 593 150 423 402 182 262 64 30 288 848 933 293 270 581 305 235 685 606
702 944 889 961 875 231 149 17 477 559 855 588 606 733 752 94 809 15 481 717
851 63 258 735 393 628 511 512 870 807 443 294 895 25 262 651 510 99 997 602
55 654 427 78 527 120 856 492 272 479 649 338 770 255 694 669 408 791 89 657
200 525 522 708 291 748 544 7 561 465 45 932 296 230 785 631 628 883 390 165
556 782 263 490 804 581 793 789 513 107 407 115 866 739 922 950 571 15 8 435
476 56 419 674 905 261 247 166 663 708 996 476 933 374 82 638 410 657 350 78
801 43 473 908 980 221 980 52 497 872 160 231 197 437 679 89 594 50 107 561
739 52 591 577 388 715 724 79 37 146 978 620 279 604 196 860 113 46 480 693
648 204 799 92 333 370 358 271 108 967 639 792 302 243 767 562 262 552 439 434
627 227 807 758 829 321 757 420 233 706 281 512 662 623 420 416 462 360 609 710
113 403 86 347 470 457 707 603 85 456 340 964 880 447 907 980 223 428 97 942
545 153 449 708 997 409 463 851 369 258 912 520 392 266 430 826 988 46 22 506
242 756 91 872 294 750 803 598 36 31 855 92 815 495 704 953 836 857 526 466
581 710 610 830 948 79 890 508 343 704 210 608 536 733 336 777 732 889 38 455
840 954 155 5 334 395 449 406 519 477 417 287 146 232 674 871 839 777 804 133
