20
552 189 98 16 579 699 252 825 608 123 531 902 380 91 799 522 245 607 446 285
852 965 630 658 597 934 671 595 100 45 24 226 357 979 5 695 497 935 710 287
1000 488 407 454 621 525 320 728 234 987 290 715 639 673 675 766 982 410 488 800
728 478 271 965 733 337 953 560 118 256 348 652 388 121 516 789 782 672 491 31
38 384 831 867 61 389 671 591 632 89 26 93 800 226 95 218 365 79 384 295
170 343 439 27 418 382 369 732 569 990 603 981 431 648 391 40 705 163 871 87
725 573 242 538 823 921 338 359 315 486 388 151 348 240 890 265 192 332 801 662
516 427 117 558 695 93 329 72 379 235 85 799 876 496 226 463 964 981 45 166
14 166 528 811 356 398 215 732 684 446 963 99 161 722 448 157 905 140 764 590
330 405 84 409 252 589 541 759 594 136 104 434 371 977 547 334 707 185 799 728
287 409 594 727 175 405 941 700 202 785 936 38 526 498 836 996 897 759 513 739
546 286 74 403 237 769 482 772 300 897 349 500 739 340 351 665 30 811 146 812
35 35 726 311 110 386 591 422 603 855 406 348 948 596 156 916 428 756 396 421
174 405 358 276 457 54 751 193 619 11 58 602 627 113 698 874 429 97 944 232
630 323 997 859 311 646 104 898 930 79 40 463 734 584 55 613 435 422 510 155
717 30 991 94 16 867 38 677 869 363 364 178 535 277 59 413 487 947 898 488
361 784 416 131 767 738 609 119 528 10 963 375 1000 761 608 272 977 580 309 750
609 251 29 237 859 463 52 592 57 137 758 809 369 409 375 389 355 173 920 619
778 492 172 918 295 339 71 378 945 31 203 379 902 61 658 882 782 607 854 135
134 763 831 127 678 657 908 721 966 429 625 917 206 293 462 873 867 867 693 71
