20
309 338 363 610 708 180 695 779 160 466 243 149 33 66 290 915 54 203 772 974
13 68 538 892 281 387 115 634 292 79 890 738 844 309 93 437 215 204 723 375
242 872 660 728 901 308 337 26 234 488 892 899 29 484 827 693 818 466 388 543
411 38 793 997 974 859 40 793 701 248 220 625 750 23 736 670 41 542 640 502
443 612 893 518 652 708 199 402 607 469 337 22 475 904 187 124 497 942 500 640
636 504 700 202 946 57 244 628 196 529 73 473 685 171 922 826 174 696 695 98
640 972 522 584 391 734 380 86 404 601 564 104 727 338 986 330 996 403 356 682
42 820 961 764 494 867 692 201 969 73 83 766 116 233 22 389 456 298 946 17
842 21 464 143 235 535 503 467 162 672 154 185 958 653 257 26 743 185 488 972
464 224 797 805 908 652 893 318 170 553 770 229 440 585 216 860 62 995 829 316
289 5 811 455 973 762 868 467 540 956 392 660 31 983 909 273 508 676 31 996
512 184 674 138 508 554 548 690 303 608 623 333 935 651 481 847 526 889 649 505
583 817 122 61 700 372 944 460 32 449 577 253 941 77 701 500 906 4 35 793
776 788 931 429 682 634 751 224 756 744 614 81 96 867 195 559 656 40 935 209
254 109 331 340 554 965 371 333 981 545 677 17 833 234 809 770 345 963 438 605
659 956 358 723 740 663 849 121 921 738 550 733 817 220 983 3 626 568 164 8
240 12 461 72 414 124 298 429 271 637 637 36 809 20 70 490 154 362 137 352
602 267 82 357 654 313 337 561 328 944 209 200 75 442 747 888 605 140 15 148
853 448 138 641 934 386 853 347 187 181 615 797 762 901 511 4 821 35 495 10
610 698 230 949 484 404 650 323 161 635 858 183 462 983 279 133 461 2 987 859
