20
792 135 279 777 372 465 455 663 120 733 667 517 782 66 885 538 30 138 755 772
38 138 849 209 210 242 719 344 765 328 123 664 500 889 832 337 151 313 444 1
845 315 684 654 729 101 567 29 267 141 90 745 654 617 607 304 31 110 212 859
730 662 675 77 633 1000 50 263 184 985 875 612 244 268 120 897 447 217 946 965
780 438 636 723 18 37 184 7 666 493 889 126 473 67 468 301 231 644 406 519
641 169 817 71 309 775 673 464 57 748 316 856 668 896 273 952 735 452 157 856
615 628 672 67 684 759 613 53 347 81 712 691 708 265 424 243 434 531 784 667
767 852 704 757 606 964 310 319 865 569 420 753 108 806 555 951 855 972 89 737
518 976 659 775 434 138 730 906 926 684 124 813 921 124 919 886 745 567 995 744
556 44 730 205 589 471 897 672 180 555 244 459 329 293 353 161 749 19 814 579
76 874 797 429 54 188 53 576 161 435 791 851 224 737 869 219 97 734 557 572
639 369 240 551 759 500 13 796 762 482 121 536 777 521 7 372 930 900 214 108
593 417 962 218 247 473 480 568 214 712 631 490 648 185 194 906 143 641 7 29
372 160 460 24 457 626 24 187 957 168 525 843 358 522 424 544 616 710 671 173
204 166 538 413 891 79 448 21 497 835 170 906 325 961 298 80 83 21 474 462
137 602 151 123 90 525 868 722 219 850 381 448 248 614 591 284 702 611 986 816
563 290 335 867 476 666 726 88 176 197 571 285 503 43 143 119 28 252 435 232
287 219 113 195 444 949 949 272 858 34 311 781 509 53 65 164 250 999 447 683
178 908 601 815 438 38 280 718 289 783 917 8 352 636 272 268 669 863 547 448
221 288 872 760 689 758 337 869 931 319 544 342 232 945 731 307 872 357 413 919
