20
48 834 620 367 648 769 984 256 336 139 178 350 861 310 550 217 649 695 684 803
42 721 694 759 148 955 303 636 929 772 447 598 860 931 451 752 247 390 710 551
159 149 203 362 843 785 361 536 988 129 280 926 836 360 553 924 474 200 274 475
861 995 570 41 535 137 665 126 476 852 694 868 581 276 361 406 93 260 100 285
384 734 848 212 647 638 796 221 757 780 425 294 885 908 984 737 414 811 486 648
325 741 110 934 586 659 609 387 301 707 882 902 669 489 31 749 822 148 103 966
992 326 6 327 810 697 796 812 344 323 589 171 483 758 413 100 845 709 54 88
610 255 232 300 432 548 863 339 2 681 167 861 855 32 437 142 873 489 572 897
182 375 793 420 22 502 176 941 816 213 884 60 244 250 102 263 323 747 13 125
46 457 306 768 312 223 11 461 92 885 470 703 500 337 502 809 675 536 77 992
117 569 520 901 139 843 409 923 95 960 482 324 648 242 239 907 497 83 910 356
504 688 60 683 303 283 660 64 791 837 941 767 369 813 607 204 430 197 846 115
581 677 469 37 635 432 630 903 229 189 936 824 797 710 905 962 607 854 732 834
493 507 664 333 87 152 692 823 630 174 286 768 799 531 901 246 25 602 678 602
473 827 950 709 620 891 393 610 389 841 274 565 572 967 912 608 935 967 536 468
801 195 652 882 252 393 116 275 990 557 678 637 701 776 183 258 34 684 491 779
317 826 689 772 116 547 121 465 103 378 789 505 393 350 378 16 914 663 835 691
958 36 535 365 365 631 679 445 475 116 338 554 363 777 598 885 952 581 478 612
423 632 822 769 134 823 846 185 50 84 914 769 632 662 479 285 913 816 545 674
700 561 492 852 748 972 135 105 26 988 190 965 380 1 398 317 180 73 659 268
