20
552 866 335 225 554 986 423 399 361 863 343 191 825 929 838 125 356 215 29 658
982 760 790 750 217 901 93 659 403 393 461 820 384 524 158 557 616 739 524 203
461 768 768 28 885 77 514 838 603 78 822 835 872 447 106 254 333 705 61 967
185 681 262 201 243 225 418 445 719 466 61 822 662 506 897 853 477 970 730 960
246 887 193 821 337 922 413 949 894 110 580 272 656 866 895 878 339 789 140 156
256 605 234 542 343 326 894 21 818 256 249 318 526 781 520 670 913 988 72 801
956 720 381 758 142 543 634 400 981 243 703 50 233 330 229 961 537 541 3 861
458 381 286 6 374 197 937 213 368 971 415 486 113 862 679 694 215 202 226 100
152 585 89 920 46 758 896 453 780 317 123 187 486 481 473 292 972 155 693 364
467 743 177 834 346 85 967 366 72 180 916 204 808 828 104 768 639 812 671 676
194 871 69 973 924 371 355 904 519 423 329 866 343 803 501 676 73 708 533 479
835 482 734 266 852 495 126 779 26 494 997 72 24 600 57 915 365 503 853 829
722 919 115 719 253 694 998 561 503 631 362 32 77 274 93 474 471 60 532 469
651 622 243 137 75 110 2 159 450 334 178 606 420 887 357 954 738 229 210 265
657 338 967 390 429 568 419 208 787 356 887 741 336 792 649 819 893 497 106 757
511 739 105 711 503 251 21 285 603 760 4 962 525 812 225 550 982 813 624 265
507 102 699 613 447 662 663 172 223 633 358 376 837 354 265 64 390 488 774 593
405 375 749 834 44 976 465 543 116 881 642 601 212 492 149 691 939 304 289 168
246 147 818 877 544 370 502 545 624 99 792 695 342 645 395 883 52 295 904 837
567 40 781 660 272 194 353 986 181 399 708 617 973 988 487 266 712 759 684 845
