20
246 987 436 5 360 91 587 395 71 24 721 137 356 984 465 562 66 927 308 572
984 204 990 605 819 9 68 154 217 618 420 297 588 584 911 194 279 729 665 855
640 295 961 19 412 168 548 821 633 590 726 943 773 389 910 586 756 30 990 720
30 436 708 483 67 110 469 648 804 252 329 38 823 355 490 872 603 945 687 220
627 175 82 988 161 699 934 811 641 783 680 373 833 314 640 315 974 357 405 828
725 867 755 532 298 368 512 76 626 617 642 352 751 556 711 693 888 402 221 825
391 162 446 914 63 472 382 696 529 750 662 346 256 783 542 613 697 326 503 896
473 390 73 458 439 934 27 134 195 501 57 812 398 2 86 97 419 617 723 469
234 551 75 182 659 115 965 297 900 626 791 372 452 853 883 656 273 738 650 772
512 840 983 135 793 846 504 32 256 812 559 142 967 170 443 358 573 48 585 98
696 844 668 312 26 440 792 87 880 504 257 243 911 252 982 901 946 946 524 93
929 427 946 845 881 438 956 115 273 260 565 766 641 515 976 468 726 371 47 515
31 852 380 945 161 191 747 379 115 611 84 926 782 56 225 473 166 132 202 394
929 667 86 849 335 348 454 141 636 585 702 897 724 945 591 983 979 927 115 448
584 786 729 463 119 713 66 733 313 33 618 613 27 543 788 495 171 190 512 737
495 782 663 860 764 803 629 429 146 226 388 512 664 192 584 487 82 942 607 287
467 803 951 949 443 618 971 756 262 729 320 501 952 94 104 763 40 426 726 815
772 50 367 301 849 533 180 55 311 169 762 277 655 928 473 52 624 665 500 816
55 638 873 554 804 711 986 884 864 455 645 160 194 867 289 799 715 793 15 265
505 876 798 654 407 779 173 988 335 120 845 581 870 23 955 127 91 804 646 730
