20
396 268 738 825 726 627 232 375 138 74 679 694 25 334 649 516 573 165 198 129
533 777 301 878 917 620 933 902 806 248 514 16 578 55 319 817 697 425 42 164
367 308 523 283 256 273 718 106 631 292 78 944 655 819 509 95 641 620 751 687
243 255 723 757 688 228 314 107 501 774 458 470 476 291 129 160 820 477 461 766
796 998 819 878 572 423 967 297 599 625 32 335 985 895 668 250 124 59 345 987
887 967 195 807 705 40 18 339 269 785 150 74 57 24 606 979 285 811 252 27
655 930 982 435 659 925 411 354 268 306 342 306 768 635 431 712 315 53 762 298
824 487 620 714 432 73 144 838 270 135 839 514 574 809 968 999 510 700 567 145
334 925 252 833 956 488 942 103 598 726 294 203 356 755 94 959 261 495 694 991
495 916 949 445 497 238 296 403 628 56 634 66 182 436 229 990 604 179 920 292
905 102 988 738 87 345 282 566 762 892 426 528 204 904 348 54 658 710 485 454
616 57 7 7 54 922 851 831 641 877 743 588 672 967 311 649 951 450 921 625
112 331 538 514 855 188 116 291 339 58 420 22 33 792 984 559 359 67 254 662
679 161 8 625 843 642 353 363 883 187 649 361 596 309 708 58 251 930 750 503
782 577 529 331 316 107 1 926 723 850 255 684 480 710 4 875 300 932 767 779
365 441 696 801 694 368 788 797 982 986 49 267 842 864 414 573 702 423 136 695
598 902 987 404 741 257 825 737 369 313 488 759 26 598 246 346 235 403 47 302
825 820 592 326 310 246 339 737 557 489 562 817 751 791 993 696 63 489 573 501
579 109 941 310 205 812 848 681 13 140 323 79 583 703 684 221 685 138 798 284
792 162 859 18 311 406 295 547 51 224 99 992 168 31 903 490 106 194 822 8
