20
173 37 685 28 943 364 535 785 986 559 444 383 236 542 550 671 540 288 31 538
202 769 805 115 445 49 73 231 339 513 855 27 719 460 452 305 154 429 832 683
521 710 152 871 232 997 746 660 612 856 475 952 580 209 758 222 209 68 487 372
640 923 850 489 950 983 189 207 728 9 810 185 399 93 279 156 901 595 603 302
931 841 380 3 400 933 975 367 996 71 257 353 5 196 315 996 265 714 640 714
811 213 847 317 201 709 89 183 410 962 863 167 870 587 507 823 981 482 173 620
213 357 714 836 511 592 739 832 426 541 231 918 675 569 892 49 186 235 765 847
997 568 694 732 104 153 584 859 638 524 415 835 258 369 182 982 818 619 959 366
54 188 572 776 399 648 896 282 772 431 257 513 773 151 124 19 276 830 321 373
533 260 125 491 630 697 114 811 114 339 963 116 490 284 464 550 146 894 960 572
314 219 748 944 11 718 343 590 113 381 374 343 802 728 29 186 556 790 552 722
213 667 231 762 502 871 18 418 702 602 955 121 929 749 621 136 514 857 620 888
737 698 109 477 772 658 565 921 47 346 622 91 627 945 147 188 322 551 38 187
233 579 696 552 720 998 850 331 828 281 406 958 651 495 876 788 110 342 127 869
720 912 617 827 189 267 154 235 359 500 146 894 149 925 255 128 829 791 354 193
490 509 973 533 637 200 862 270 892 555 417 630 367 503 505 716 87 70 796 888
633 693 379 58 521 274 435 972 354 90 935 455 406 98 875 345 469 362 621 856
554 99 348 893 847 179 23 568 545 695 612 294 165 104 283 242 316 26 918 491
947 808 323 602 371 145 992 868 67 622 43 986 918 504 460 424 683 994 968 865
750 415 478 881 308 670 436 994 226 427 562 263 577 627 599 831 546 929 14 126
