20
204 145 569 165 309 782 934 722 772 866 397 453 965 124 213 872 756 685 494 330
243 591 766 709 61 218 900 419 937 993 650 854 942 165 539 65 796 165 370 550
325 654 587 945 609 890 226 891 880 95 583 723 584 292 656 745 340 198 804 537
614 138 731 377 107 990 863 292 465 715 199 170 745 31 95 449 619 852 213 775
185 543 264 411 535 785 9 849 621 46 508 929 212 869 435 666 313 353 319 249
574 712 249 998 301 447 906 309 893 813 267 721 210 904 30 901 857 494 19 288
766 350 101 834 651 493 73 77 131 665 571 975 778 773 54 828 861 387 763 41
208 736 623 749 631 213 425 607 759 447 493 614 675 146 822 153 64 35 243 254
650 985 620 213 336 532 742 242 150 147 69 116 810 424 858 606 29 750 858 464
500 659 89 616 987 23 987 667 501 515 141 83 865 220 92 998 57 185 207 718
981 599 543 758 464 682 933 776 49 924 603 545 889 699 25 401 913 50 721 533
974 428 498 496 158 384 248 501 565 25 715 58 965 816 352 170 489 183 798 817
813 503 983 113 971 180 258 506 425 748 419 602 195 563 370 598 853 111 600 830
314 519 598 823 289 775 849 650 716 370 900 494 846 42 754 327 242 425 674 662
971 775 572 250 258 246 389 322 670 965 293 419 974 505 798 959 677 128 569 644
624 752 675 262 205 290 363 968 200 306 342 9 13 259 980 36 895 841 908 28
117 12 369 4 188 634 914 977 679 74 544 576 692 590 874 636 221 959 609 884
264 176 598 181 123 515 807 72 964 216 341 78 167 562 656 390 777 350 983 14
881 433 965 545 630 507 842 745 212 633 947 103 594 422 895 449 147 432 193 75
932 660 577 478 757 97 56 261 649 82 438 397 573 208 421 450 114 251 448 398
