20
218 257 807 440 480 98 301 355 808 4 883 447 70 8 497 260 566 381 343 237
812 603 670 614 955 157 374 651 458 688 385 893 986 532 173 608 442 195 745 199
234 400 314 750 188 751 588 883 891 606 322 282 862 576 661 125 992 401 81 298
595 464 12 810 121 395 326 633 801 966 263 942 679 496 862 297 354 400 985 919
343 611 200 196 668 975 319 579 716 946 335 903 999 616 265 486 989 75 311 106
532 695 239 762 40 920 691 369 856 257 563 761 756 336 467 786 386 655 310 591
899 72 906 456 292 96 598 967 84 635 807 749 462 285 763 133 461 780 806 829
595 193 368 55 640 889 762 715 13 965 898 294 697 636 115 681 708 176 662 958
501 731 913 691 961 489 212 958 416 289 896 669 176 121 636 256 793 185 781 858
578 154 366 760 825 514 499 926 702 386 82 105 463 684 94 683 422 57 223 775
350 192 59 693 609 906 995 728 318 831 896 775 875 823 449 607 542 558 91 319
989 690 796 75 309 402 672 672 886 638 645 954 615 418 654 321 925 62 302 470
189 303 549 833 839 167 816 19 930 396 259 255 914 189 804 846 404 339 841 251
799 831 136 935 744 711 12 544 699 793 431 347 735 487 832 712 446 106 660 279
377 852 387 956 587 68 194 142 957 830 46 62 108 560 718 800 278 499 352 27
413 40 159 682 183 103 159 903 293 247 275 707 584 944 142 989 491 562 744 331
355 940 294 202 811 221 843 218 289 582 327 844 110 805 449 849 868 821 623 805
956 557 257 99 853 937 73 160 366 831 50 367 343 992 82 742 175 116 549 568
680 896 308 955 47 706 4 82 219 865 263 292 972 594 389 905 42 644 280 47
713 210 210 599 753 953 864 360 250 553 84 853 288 34 53 543 560 889 758 856
