20
979 895 731 203 89 327 268 912 700 959 441 546 313 861 216 867 853 145 345 819
318 807 617 140 432 48 573 226 216 818 196 222 749 472 29 737 399 440 922 909
597 409 246 500 767 93 398 366 937 583 212 976 391 81 375 627 473 779 406 105
759 81 437 331 204 247 170 379 514 249 759 671 165 653 182 662 936 894 196 832
199 842 523 798 744 381 576 112 328 718 449 564 132 962 361 215 771 116 579 409
70 69 31 496 388 77 623 464 746 726 133 291 418 62 86 659 73 600 537 164
110 597 420 536 803 146 666 823 780 427 762 251 510 806 444 617 203 68 744 467
110 688 679 953 166 636 157 171 845 936 877 528 773 251 619 586 389 64 391 862
183 736 468 790 167 958 449 644 745 402 679 541 957 42 644 497 349 424 52 902
492 204 89 376 959 320 170 390 488 494 859 90 312 247 722 1 826 846 546 292
591 113 179 811 962 600 31 371 825 773 316 127 853 556 169 451 466 93 101 610
772 678 450 340 490 614 874 744 62 700 6 814 947 309 803 5 752 977 649 177
351 949 642 248 16 641 824 214 354 980 283 930 643 928 197 414 785 174 446 900
410 268 514 209 436 54 341 826 654 621 344 305 76 629 619 458 269 556 874 223
10 890 163 397 471 13 910 763 916 148 16 695 669 18 55 391 76 486 622 139
113 885 548 550 999 987 287 604 977 740 916 955 987 645 38 381 330 444 516 156
685 313 73 262 615 244 1000 197 8 863 64 620 265 302 507 689 493 737 103 408
430 265 223 212 637 157 319 886 919 907 378 87 737 668 403 990 618 882 89 495
58 217 25 450 654 854 351 239 140 122 147 192 830 430 365 25 765 906 184 341
129 510 221 64 389 912 417 816 804 333 155 193 682 899 41 603 291 200 79 157
