20
118 766 908 762 706 345 370 798 33 316 931 62 746 507 298 346 538 661 787 566
658 75 653 938 982 22 798 71 69 406 474 581 148 7 614 117 100 733 812 9
833 655 421 747 412 631 836 83 496 957 914 842 594 472 903 123 537 281 618 430
91 65 884 977 233 254 254 729 272 513 502 474 999 646 548 37 619 416 931 667
832 670 877 644 553 797 364 642 742 560 594 14 199 607 329 281 500 618 924 411
303 647 523 114 252 996 913 747 648 364 29 920 120 386 955 711 968 281 19 12
498 727 496 270 147 25 918 960 9 392 571 233 195 663 28 814 103 265 768 424
540 573 108 199 583 150 496 940 545 901 480 421 954 573 700 346 471 537 330 746
494 759 398 771 855 712 471 235 410 334 627 164 626 693 772 366 979 913 221 820
408 996 969 769 637 821 167 605 147 190 84 598 43 939 370 303 509 846 449 892
107 751 471 319 802 254 849 777 931 999 923 706 451 472 644 203 83 816 805 111
995 668 597 590 521 712 903 913 248 682 760 796 232 958 447 768 815 621 583 662
535 866 874 958 389 184 614 138 574 469 981 891 232 233 404 304 413 998 981 590
898 558 292 557 200 124 593 607 247 496 915 217 758 811 125 997 71 987 121 900
252 714 347 553 447 457 427 542 786 11 142 959 850 496 770 310 668 18 786 329
645 744 56 199 731 172 862 336 804 898 360 4 414 664 702 537 369 783 631 810
662 412 841 998 232 574 445 646 112 839 548 779 742 166 760 258 688 511 920 679
366 750 98 912 949 110 931 506 82 768 593 557 952 641 398 910 771 343 287 986
612 837 957 861 945 442 690 692 467 806 480 418 521 808 489 531 95 447 354 360
203 291 735 663 314 502 834 480 801 275 651 509 135 398 727 787 29 923 977 527
