20
508 158 36 627 169 716 122 629 194 795 122 121 556 736 847 43 690 724 673 977
230 924 373 465 388 36 25 998 71 451 500 372 575 476 828 372 296 492 721 967
982 355 838 340 178 803 680 281 272 241 826 385 937 276 382 844 45 83 641 355
283 850 201 845 133 614 106 719 377 553 106 901 481 26 731 653 722 640 207 116
198 330 821 86 199 963 837 823 724 175 710 905 371 989 52 123 858 284 906 237
256 382 365 86 553 16 300 471 650 39 258 518 582 748 573 942 751 437 220 692
691 815 979 683 862 753 307 768 121 569 808 210 117 201 922 6 803 382 633 452
783 733 39 326 623 781 794 40 51 547 533 851 11 563 235 848 203 695 306 324
610 439 539 546 145 749 299 181 111 441 673 21 723 111 934 941 309 675 607 280
219 321 497 493 908 951 819 804 683 55 431 151 15 787 212 131 599 508 675 617
263 769 252 591 117 807 617 560 884 311 503 539 336 262 72 931 733 334 405 453
103 99 355 894 288 743 214 355 617 76 50 817 208 453 905 976 620 979 496 572
822 923 501 213 387 215 248 901 678 754 260 412 230 723 917 65 764 763 303 818
503 732 26 584 997 460 879 626 203 621 214 863 237 866 371 302 979 492 288 600
346 724 962 164 248 365 202 678 233 249 110 224 600 401 111 984 641 683 984 155
217 539 468 431 582 199 972 784 672 914 114 541 113 760 432 388 459 815 820 129
497 597 167 700 904 378 557 886 746 495 976 396 564 779 90 58 349 20 313 68
170 958 779 588 452 674 254 50 156 211 68 405 497 155 373 841 660 678 245 678
112 449 56 785 805 661 887 21 315 972 712 126 483 865 731 733 818 856 136 275
181 220 105 278 147 902 58 44 542 779 582 571 725 77 932 767 981 55 302 918
