20
793 32 767 827 415 594 408 394 155 608 471 462 828 970 988 75 111 197 182 338
647 710 56 240 465 468 239 725 918 138 461 434 436 797 916 978 933 593 877 205
452 543 652 946 14 825 153 528 190 794 951 182 944 229 404 883 245 227 118 327
507 178 19 897 876 629 885 254 966 627 118 114 806 128 339 312 651 855 411 369
939 241 664 699 33 45 486 332 379 595 594 87 532 242 736 560 120 974 216 700
810 768 97 392 577 656 524 65 884 756 700 895 987 619 339 362 674 765 158 256
694 946 126 158 90 665 624 685 746 275 10 934 609 847 434 879 68 672 763 375
337 423 600 466 648 146 745 246 602 796 318 698 201 873 425 421 446 404 62 696
959 531 633 775 569 940 490 270 977 135 805 789 456 549 248 212 389 558 38 761
825 63 309 332 6 244 844 42 795 575 869 934 248 11 375 657 270 376 856 583
729 773 432 958 37 640 250 746 206 712 546 849 573 736 301 277 229 6 474 789
212 402 307 1000 228 805 397 43 805 5 239 989 272 968 645 929 712 149 976 793
39 243 805 848 345 952 579 122 47 252 300 349 88 76 49 328 48 961 502 626
314 479 554 71 488 591 226 769 126 291 621 201 54 195 507 661 93 457 787 443
252 81 560 997 557 902 117 80 934 396 454 407 50 524 643 741 872 83 230 507
728 365 413 106 473 897 376 645 372 400 987 563 837 973 600 40 532 841 617 821
739 312 764 497 611 273 269 157 374 353 835 462 689 47 129 986 609 770 219 801
624 847 375 105 511 670 25 252 365 528 304 446 169 459 715 2 872 740 404 112
210 651 429 100 673 126 167 171 634 479 726 111 858 362 964 91 303 307 31 19
438 849 216 162 284 706 171 733 884 429 46 837 865 571 249 185 392 630 791 141
