20
53 914 316 628 132 11 459 635 345 748 865 455 819 504 565 567 721 183 406 332
175 22 273 237 270 734 267 700 886 26 393 414 472 253 931 751 976 216 872 419
897 470 185 346 12 788 375 440 277 738 884 693 595 531 149 140 268 737 702 965
940 383 701 972 496 294 828 469 637 705 542 457 510 147 582 968 400 90 64 134
40 991 354 232 434 260 995 606 669 964 895 395 727 741 819 87 893 376 753 96
399 178 311 989 632 609 315 296 218 914 187 226 94 256 663 10 490 121 618 527
764 6 281 173 547 87 719 443 652 488 420 196 661 97 980 287 824 666 851 757
406 292 918 721 666 847 553 266 983 735 957 759 514 373 27 204 50 831 300 874
613 370 31 665 568 744 806 735 194 332 727 176 284 57 281 702 769 333 781 345
690 508 360 181 546 452 492 904 88 45 451 627 230 795 149 269 732 745 199 975
166 784 14 989 577 359 154 399 931 933 367 803 424 294 777 444 626 74 887 980
15 559 783 420 617 538 340 917 17 34 954 660 306 137 838 460 136 630 358 740
497 380 425 593 202 688 675 248 797 173 251 318 762 404 799 258 759 322 376 129
333 852 230 892 631 955 824 617 280 869 505 264 11 652 639 4 971 142 899 295
499 259 506 396 878 509 428 672 521 894 329 222 965 398 853 170 209 121 175 918
700 441 516 942 295 468 414 577 666 819 411 225 306 901 820 571 562 179 599 140
508 542 701 491 23 915 574 854 938 145 510 369 372 492 62 913 528 203 566 866
125 32 200 575 90 553 952 461 399 195 222 635 986 172 505 85 625 797 456 857
321 257 897 367 158 274 232 269 819 16 598 273 857 313 824 600 326 396 547 986
674 413 961 280 136 859 391 598 994 995 689 253 430 528 446 356 265 753 530 259
