20
936 239 945 886 56 356 708 581 850 155 859 980 618 423 205 608 865 186 477 657
922 843 189 280 438 218 502 1 649 507 255 127 225 955 712 107 971 987 781 533
379 335 294 138 951 601 897 619 432 938 359 507 546 948 407 799 203 27 984 545
168 398 146 899 660 880 743 996 351 836 505 509 766 663 869 496 300 319 638 79
784 413 929 996 460 860 919 543 497 203 692 757 360 94 367 994 318 862 89 752
890 685 86 605 579 102 813 575 168 345 147 388 532 760 899 319 539 816 32 78
276 573 478 706 125 706 674 167 563 747 137 730 283 521 777 633 964 502 674 732
456 984 812 639 550 657 175 944 34 959 536 975 645 719 125 975 654 441 672 189
694 634 554 317 489 701 453 517 631 4 755 837 361 962 320 916 776 502 276 984
67 141 985 277 854 766 895 663 591 675 238 801 639 228 302 583 833 57 844 491
119 101 334 384 961 263 635 615 875 853 503 230 971 937 362 154 724 997 302 817
829 183 442 712 123 807 800 138 808 706 696 620 60 493 771 868 952 85 586 281
601 858 941 26 2 125 782 600 161 791 869 719 66 365 475 406 682 334 235 156
376 399 116 811 650 441 824 724 452 204 878 59 263 828 884 90 64 160 471 245
469 642 623 196 115 522 37 182 138 5 850 17 304 210 878 993 717 797 160 531
689 945 618 487 369 677 52 372 297 294 50 753 155 19 477 806 712 453 986 527
363 250 451 187 539 956 619 84 113 356 14 752 732 996 707 24 174 984 642 463
542 529 38 825 168 831 140 585 492 985 792 50 394 307 829 517 348 991 578 476
924 760 614 889 827 984 867 5 775 705 199 105 434 892 748 275 128 102 426 837
297 189 245 978 583 916 907 656 727 750 833 351 796 44 766 904 247 858 645 348
