20
623 689 518 170 368 61 650 380 565 673 813 124 146 440 482 949 541 535 233 792
661 851 309 368 597 743 4 755 554 365 676 996 834 661 410 635 637 619 199 908
138 623 823 375 509 943 270 378 601 962 679 691 54 294 295 458 396 295 766 710
611 166 555 300 584 768 305 556 884 491 399 34 308 375 775 412 379 664 772 324
445 787 928 369 72 681 997 907 178 476 87 133 371 688 112 92 80 673 669 505
634 17 112 2 948 219 389 768 371 76 715 411 114 178 52 300 788 536 931 690
421 28 519 403 306 55 407 431 752 214 511 381 895 592 602 668 127 873 899 833
552 963 263 619 955 565 632 526 751 956 155 253 678 245 735 806 907 357 355 957
822 793 304 424 309 698 637 108 141 803 687 986 314 641 923 243 910 349 81 263
22 548 590 956 289 459 276 143 970 109 636 48 627 901 301 841 335 811 147 114
397 725 647 229 704 585 818 373 663 558 159 549 469 175 134 541 100 65 217 552
25 546 181 877 91 653 166 492 976 878 529 185 164 30 544 487 922 664 150 243
864 643 223 68 842 707 332 319 919 668 111 216 581 716 644 4 465 168 39 112
310 215 50 751 605 66 944 93 534 775 297 965 994 273 852 980 20 392 335 975
981 724 140 55 670 389 199 215 891 548 807 464 391 629 533 340 658 26 844 819
10 552 747 326 50 953 876 708 961 567 69 466 637 418 99 930 236 229 444 482
636 483 142 406 312 393 725 431 567 335 108 532 548 558 203 892 2 74 31 824
773 319 204 316 73 616 510 932 44 251 665 519 598 499 733 417 233 800 173 332
100 278 998 959 597 249 485 994 475 625 640 882 446 879 128 828 603 65 588 172
383 229 148 60 652 430 605 900 405 972 542 20 294 45 375 358 310 109 877 860
