20
42 78 401 170 900 47 346 104 627 867 117 562 969 627 867 188 204 925 395 977
577 555 108 80 642 705 40 994 621 61 327 950 264 813 274 873 15 193 355 136
796 639 687 70 310 405 560 307 693 150 631 520 549 184 703 699 303 866 740 785
467 294 859 882 336 654 638 704 858 973 877 942 246 832 764 33 637 479 840 951
93 352 731 674 488 841 940 941 427 398 806 829 158 627 595 844 377 376 712 48
228 696 546 953 802 335 359 761 808 18 403 176 980 698 125 117 734 71 300 213
855 973 902 797 517 831 549 316 886 190 708 966 612 128 602 355 705 665 178 182
798 32 884 934 807 144 910 396 401 233 503 939 358 669 174 532 843 846 220 587
618 660 487 793 823 460 117 686 367 414 649 400 976 735 291 837 770 861 580 940
828 830 233 667 948 668 283 806 927 222 278 994 76 993 218 134 452 108 387 920
31 257 596 618 531 858 201 602 343 134 732 451 709 643 349 51 428 78 544 791
667 756 43 233 974 677 237 225 14 873 459 779 810 865 224 629 745 57 443 814
585 294 671 427 918 233 547 889 410 951 543 307 680 216 804 17 846 674 192 584
205 552 549 282 151 640 250 252 377 865 598 24 210 230 314 171 945 410 999 772
502 902 45 742 570 807 196 67 528 464 479 372 832 635 864 163 906 858 199 857
636 819 327 247 394 26 395 898 777 27 792 707 6 316 463 695 107 407 664 60
990 258 466 164 580 454 839 842 231 570 653 240 802 68 113 130 912 386 546 42
927 195 679 29 48 732 461 580 808 17 866 347 806 135 830 305 966 970 715 238
480 901 912 678 203 231 743 978 198 271 803 814 251 932 117 475 970 167 808 290
36 53 669 129 853 124 86 753 815 584 232 548 337 343 236 771 759 159 739 967
