20
352 200 349 341 293 678 501 300 105 396 426 449 515 220 758 587 959 901 670 86
984 402 102 221 253 238 603 152 398 97 306 253 641 207 22 746 139 273 768 323
626 57 581 944 282 815 422 386 908 51 705 724 140 614 577 679 272 523 100 555
728 625 373 812 532 989 538 844 950 668 906 557 11 330 268 931 612 907 722 756
976 364 831 148 782 569 103 760 822 74 383 523 307 434 789 197 450 570 453 383
240 631 125 64 454 814 472 39 409 266 180 567 118 618 196 773 766 668 853 563
440 630 870 780 993 97 341 738 740 472 655 620 58 14 219 768 975 161 898 873
164 282 243 685 974 350 752 162 29 475 849 743 418 134 612 559 406 845 562 457
73 661 828 713 766 576 419 617 126 147 50 233 380 342 436 112 675 132 349 289
171 246 834 906 56 98 970 8 184 704 817 377 579 371 708 853 453 423 596 509
396 992 503 241 937 683 844 464 839 884 213 254 910 436 918 234 222 865 291 485
12 709 69 891 513 304 365 913 702 272 818 61 229 27 618 427 889 575 302 727
825 79 655 262 598 779 843 470 208 529 724 563 723 212 317 88 706 209 42 733
396 708 994 385 835 878 542 746 840 615 242 502 500 989 336 689 125 949 804 697
905 164 914 398 709 498 969 258 634 78 286 810 672 824 260 670 320 756 309 636
291 712 393 154 220 991 253 262 288 101 833 267 711 145 5 999 368 617 67 43
576 83 33 809 930 377 927 92 121 874 507 466 19 824 587 963 235 831 925 694
757 809 729 804 188 179 295 279 786 448 533 474 283 139 110 440 392 85 725 343
907 313 996 314 75 176 478 582 895 21 244 204 249 993 567 733 829 605 688 495
722 961 194 858 821 781 945 707 831 481 801 108 449 496 168 262 191 392 889 483
