20
252 9 280 699 189 874 825 760 491 300 102 55 75 921 220 337 917 333 382 572
707 159 515 163 707 162 801 959 147 371 214 356 584 554 108 279 605 148 413 630
418 445 491 652 130 812 988 594 460 304 327 576 711 59 460 940 633 470 129 296
664 774 52 32 742 751 706 422 951 239 318 426 415 739 153 437 883 29 65 897
931 667 656 805 817 643 774 75 607 248 36 846 413 408 729 361 559 7 320 358
46 955 726 844 347 57 458 252 572 452 530 625 996 81 757 110 95 642 590 871
88 121 886 615 293 393 331 502 763 444 646 389 194 478 471 298 869 546 263 676
234 317 142 798 902 14 349 227 773 451 680 250 98 113 457 563 168 321 363 369
590 264 74 853 756 623 777 575 116 828 114 669 419 307 107 65 980 480 858 269
408 728 433 425 896 736 479 167 600 856 956 989 982 473 492 820 460 883 530 483
210 921 992 96 767 378 578 251 909 198 714 971 515 221 133 288 482 928 861 738
14 667 206 587 920 385 725 464 273 935 451 660 110 311 67 652 506 338 157 239
752 961 974 106 591 398 933 501 115 779 160 744 814 633 193 113 691 530 510 196
640 509 293 374 399 930 809 462 945 481 619 253 705 831 832 900 97 757 48 555
401 327 363 122 474 447 648 165 679 594 938 358 777 937 30 829 628 644 919 213
861 34 488 877 690 907 214 401 313 678 471 156 337 879 117 426 715 227 698 468
675 157 328 153 157 695 654 496 604 1 185 397 30 229 245 158 698 16 430 542
61 550 879 462 696 729 31 299 567 209 884 309 777 397 180 880 911 831 631 549
745 615 80 198 830 712 292 79 196 758 986 290 272 465 959 578 832 565 404 80
728 110 388 711 104 991 884 842 576 738 317 403 699 402 124 489 520 924 621 664
