20
989 372 119 980 19 726 350 793 633 416 650 961 935 82 357 640 670 930 458 991
147 653 465 790 354 993 64 344 966 692 266 410 970 19 74 982 334 234 736 774
892 505 485 717 147 904 855 672 657 948 750 390 255 883 856 335 219 249 67 688
724 63 697 682 41 831 634 588 115 47 400 604 628 154 822 685 578 376 658 701
415 495 910 305 159 193 572 884 819 261 363 656 337 232 272 189 249 598 760 712
308 241 546 691 541 417 638 78 616 840 123 906 114 102 632 993 883 232 473 732
74 122 891 400 3 350 72 970 865 196 678 277 126 947 176 270 72 699 106 807
818 184 318 904 912 611 392 20 989 746 862 171 51 324 286 950 602 208 997 633
62 963 234 537 760 501 631 412 559 518 936 93 227 529 573 765 351 291 383 51
279 261 704 584 670 919 205 254 710 259 555 436 145 474 79 477 558 668 721 568
499 41 113 386 639 512 311 782 935 291 571 821 532 83 280 7 989 98 105 451
379 839 303 249 497 434 410 141 703 622 456 100 500 167 938 900 73 778 566 168
634 791 995 971 90 250 290 673 15 295 185 573 532 522 100 747 81 487 788 182
439 255 782 692 73 766 604 827 683 568 767 356 331 640 759 452 506 595 823 623
673 726 174 194 318 597 96 626 845 377 906 461 246 248 118 712 771 130 773 543
561 356 1 187 109 169 155 315 1 746 436 330 840 685 449 255 576 567 238 210
446 904 83 430 792 809 237 733 858 445 927 615 622 861 933 310 666 827 678 162
201 872 385 627 780 615 582 537 757 83 403 776 26 547 842 592 507 124 111 829
873 693 352 602 960 19 416 523 662 68 728 498 521 748 494 419 172 765 423 390
755 742 409 913 618 188 513 845 781 199 68 849 784 812 889 523 392 372 876 343
