20
883 347 526 630 328 947 893 225 633 336 748 334 713 223 850 888 916 77 746 648
250 582 610 257 937 592 975 523 257 133 136 1000 166 691 126 216 2 959 905 159
663 631 176 35 395 890 18 692 737 916 580 140 18 658 436 95 910 213 689 250
633 561 90 719 28 591 256 855 311 284 946 592 224 540 332 658 704 273 68 790
88 385 99 814 862 267 184 69 292 486 620 718 862 844 126 102 925 685 968 512
204 621 200 165 225 315 727 86 174 809 630 803 514 467 591 678 36 800 454 561
60 801 12 364 862 71 309 102 807 961 346 480 995 865 528 24 462 404 628 578
57 296 726 130 69 275 530 858 839 426 199 514 186 488 287 239 134 954 193 281
571 377 268 108 413 419 79 985 231 688 393 309 912 857 437 174 484 939 895 282
890 601 782 762 909 879 276 323 124 484 107 582 283 595 434 540 654 730 801 362
295 90 359 6 582 552 31 332 103 863 838 223 843 447 494 735 963 405 120 514
725 740 625 37 568 461 347 174 370 390 627 761 341 184 69 755 866 991 1 909
486 217 415 17 508 603 688 486 393 54 820 705 214 966 397 446 306 424 764 121
261 873 913 140 708 764 484 988 872 356 731 939 328 102 166 190 781 766 110 665
58 360 431 618 432 28 714 297 407 491 399 939 353 936 460 346 316 821 533 954
801 705 765 16 831 762 539 495 850 729 280 435 717 1 907 697 203 85 987 346
44 983 9 765 684 962 274 13 623 79 106 321 686 346 430 394 54 875 774 130
811 725 233 123 175 902 819 686 557 869 896 468 497 299 666 524 665 408 317 729
358 877 7 10 697 528 46 803 381 305 33 194 178 754 744 914 400 455 153 512
486 887 892 277 239 472 591 722 409 536 158 869 451 796 509 393 106 406 690 204
