20
944 203 916 937 587 988 622 650 100 486 225 546 656 555 290 902 278 237 959 88
808 744 446 39 918 250 200 632 543 891 125 693 141 33 60 395 891 93 717 897
633 430 962 52 794 769 611 948 719 708 46 670 582 719 408 765 279 524 894 999
442 905 102 561 957 133 631 611 897 80 468 284 613 238 53 725 798 94 300 816
645 763 429 892 30 171 278 328 185 871 396 400 664 603 276 666 880 223 318 372
126 713 794 289 487 579 794 556 207 660 660 48 156 412 695 488 390 134 426 512
988 321 397 635 181 912 373 635 261 847 378 579 564 261 438 290 882 168 2 348
555 869 350 471 729 500 220 755 429 871 315 813 976 33 978 441 217 740 476 889
925 661 203 602 851 308 796 458 568 694 171 659 160 726 89 396 494 915 444 91
242 21 736 89 845 656 149 589 444 99 955 533 233 153 101 708 468 82 22 851
330 172 989 780 890 217 235 545 325 369 127 168 713 332 246 16 668 206 769 989
468 705 217 268 12 224 481 283 116 914 540 950 220 942 826 336 674 60 316 335
927 757 760 504 775 542 986 797 568 755 287 895 524 571 566 358 483 62 752 579
458 961 375 601 276 813 612 472 279 314 199 194 250 323 938 806 876 149 434 389
530 399 197 565 202 488 28 318 388 197 59 188 607 518 239 143 890 886 901 580
69 177 78 131 282 949 111 567 342 923 156 115 646 964 732 260 515 797 649 551
933 441 211 376 834 700 199 415 960 793 782 157 859 999 524 594 461 619 989 912
142 937 303 421 651 572 715 890 178 924 972 811 36 279 649 124 996 296 777 556
857 290 522 722 644 708 631 107 786 655 20 233 759 327 900 190 128 106 737 380
90 775 697 691 515 810 278 26 471 265 54 552 769 464 182 50 813 333 260 633
