20
249 307 667 698 180 792 216 777 2 310 867 800 298 792 670 860 616 410 153 974
462 980 707 365 578 416 944 499 91 408 428 323 965 878 388 439 405 493 161 799
814 335 854 365 542 747 928 593 872 1 992 935 206 389 177 807 378 710 311 464
208 802 869 455 681 94 142 118 684 600 95 403 271 695 365 750 333 560 167 181
367 501 399 585 629 752 381 446 230 885 754 830 281 842 699 587 923 732 550 447
93 827 994 210 698 232 518 638 520 398 482 479 135 113 354 734 871 137 83 130
817 905 798 592 68 984 6 306 600 928 482 286 845 228 363 523 173 159 471 60
136 975 648 875 510 437 282 178 960 597 311 296 909 643 445 911 168 156 455 676
799 967 234 89 952 982 492 490 591 732 936 464 284 370 813 184 395 775 676 181
768 777 767 974 589 753 148 349 688 425 628 424 405 628 606 366 788 605 50 877
905 997 649 553 490 464 225 826 332 527 930 910 672 639 720 835 467 907 426 333
123 482 510 344 464 995 378 105 479 615 349 709 776 974 518 549 492 577 287 777
253 417 980 432 624 887 848 261 973 83 178 684 919 97 482 572 152 78 483 914
700 447 73 998 160 104 938 103 619 99 772 85 587 259 622 963 796 722 79 47
372 754 792 594 199 558 266 13 839 356 486 386 190 90 525 172 788 963 123 167
774 757 114 685 816 189 798 164 274 287 982 321 337 914 987 466 224 200 737 211
299 733 988 849 498 646 442 558 820 691 227 234 34 400 925 621 226 494 425 767
685 615 109 263 734 226 945 206 553 752 175 32 885 955 49 499 757 207 645 196
349 920 656 903 664 485 378 745 868 103 310 812 140 413 327 979 86 518 657 814
258 197 32 429 100 527 304 881 984 518 172 635 213 553 858 572 174 830 933 739
