20
763 373 615 651 639 651 349 825 974 808 791 966 559 288 59 992 599 192 233 721
393 683 731 856 224 479 771 312 979 410 784 699 367 833 547 980 895 966 276 956
628 37 703 679 67 245 335 683 22 786 655 201 592 3 187 341 815 322 270 931
509 612 131 751 239 799 121 106 22 878 854 809 116 395 299 636 772 200 791 560
639 798 856 96 628 427 945 430 810 27 668 91 61 608 597 695 520 92 571 588
435 154 336 956 2 454 698 282 863 828 521 952 132 190 140 281 571 651 375 386
705 769 271 637 56 713 446 30 542 660 91 997 69 558 128 215 695 603 390 501
386 851 179 880 234 927 352 562 908 464 634 988 527 828 245 256 509 701 829 247
943 195 920 53 691 469 790 81 979 848 848 520 221 71 349 109 802 993 46 1
433 944 506 404 137 675 136 240 724 665 773 581 245 931 870 294 376 710 645 295
119 454 7 797 575 129 657 249 991 261 836 811 208 362 171 642 511 1000 181 911
386 469 979 418 894 624 27 993 359 233 272 793 741 422 582 614 321 431 607 437
686 103 760 115 550 355 767 543 40 52 623 192 294 784 56 269 440 676 55 539
799 884 935 365 349 626 776 670 1000 675 917 378 687 385 605 710 955 869 390 902
188 956 517 259 626 911 351 813 76 326 117 474 923 646 799 350 2 590 305 512
111 56 716 984 733 96 658 68 605 689 365 374 67 378 767 653 885 143 749 274
845 139 893 997 822 472 947 409 944 581 586 857 598 273 131 578 592 36 50 336
420 941 106 339 853 503 32 549 485 282 627 990 91 534 515 42 306 856 871 257
4 922 202 367 931 602 148 188 712 525 310 956 466 356 938 413 982 470 718 723
291 28 592 164 222 193 611 526 734 812 976 792 412 532 123 329 547 342 63 816
