20
426 731 51 439 666 375 434 761 983 261 972 993 547 439 55 179 733 85 357 25
474 650 683 713 400 467 909 350 13 855 599 860 267 693 172 300 123 748 325 549
964 705 272 34 377 627 705 57 816 661 136 960 894 324 987 998 149 483 727 914
337 647 510 303 451 372 755 204 987 128 119 591 534 514 497 666 171 114 887 891
877 263 107 830 427 921 305 387 106 965 794 280 365 127 897 712 946 596 685 855
508 364 657 8 269 869 857 498 457 831 605 177 589 304 944 716 650 975 561 56
854 509 646 221 672 471 382 572 684 371 196 278 83 608 293 761 835 781 687 23
89 879 141 537 465 803 947 889 265 549 225 903 856 271 531 889 95 226 334 618
470 664 528 31 624 441 504 888 382 850 143 808 117 607 1000 268 762 729 476 287
205 754 349 407 263 218 302 105 754 817 276 596 692 681 246 583 234 741 636 163
461 197 416 538 944 175 898 976 206 743 563 140 725 687 56 259 400 479 755 357
341 841 339 246 142 698 354 182 299 930 782 867 186 814 699 362 55 95 822 708
169 396 359 152 766 678 977 884 932 136 382 177 176 146 324 216 624 589 935 469
357 583 366 657 402 512 220 561 311 397 694 775 338 338 804 342 521 546 983 152
466 425 249 420 562 410 68 617 600 297 273 862 154 701 134 100 823 207 108 80
45 889 669 469 458 38 851 765 979 346 82 39 974 189 423 325 456 650 567 12
914 934 727 895 328 306 599 337 411 128 800 946 1 166 438 438 534 344 625 770
239 192 447 574 125 218 913 22 791 168 14 321 465 807 902 415 875 506 895 691
601 997 969 981 569 432 638 725 607 577 457 599 637 504 965 615 758 199 296 293
466 624 271 631 508 837 639 414 203 508 626 453 337 948 175 655 487 610 223 764
