20
59 644 66 893 581 66 628 619 272 713 286 354 384 874 272 842 85 641 56 316
868 862 507 212 691 520 370 741 771 496 985 895 538 648 885 897 470 986 226 752
165 192 994 811 635 432 589 776 968 282 760 916 508 703 999 340 438 899 856 359
241 205 102 74 343 788 910 612 96 44 479 240 334 21 161 381 646 640 961 943
195 457 775 245 435 362 952 805 681 343 315 31 256 579 130 33 158 684 170 748
404 36 256 953 407 55 447 405 680 701 158 424 841 612 87 10 452 983 241 375
967 38 734 466 47 365 984 744 463 876 599 6 321 169 473 683 477 37 830 554
763 769 193 839 654 202 50 2 506 983 257 8 276 136 587 298 182 389 664 233
17 385 976 624 335 541 968 545 517 371 876 716 929 831 924 492 636 840 641 136
275 899 400 309 383 999 973 503 646 891 717 605 358 481 679 882 489 169 987 990
18 120 148 819 846 700 91 227 787 66 319 410 879 232 445 58 978 782 5 699
617 435 5 422 266 592 199 137 966 625 810 23 228 476 370 615 307 470 154 20
803 871 157 923 27 165 80 132 410 727 696 675 206 905 401 682 610 226 324 273
126 819 403 829 371 609 453 549 878 487 351 324 882 209 4 474 237 814 67 417
118 123 798 909 137 761 799 764 554 341 84 390 196 931 283 262 540 427 570 195
721 837 178 371 695 390 920 830 682 101 342 440 789 211 606 10 418 502 171 747
446 147 402 194 716 24 439 305 515 454 617 309 503 959 991 823 455 529 426 121
796 817 257 263 329 346 233 576 684 45 744 5 114 269 121 317 989 51 429 15
196 363 390 471 92 823 41 418 865 660 959 629 204 851 848 866 800 825 912 360
812 952 428 944 550 137 567 942 861 110 796 14 814 102 470 42 260 210 271 447
