20
31 974 630 236 791 308 451 627 860 956 451 148 751 53 463 941 49 899 160 860
471 151 607 390 663 769 69 819 951 179 523 90 898 478 192 566 731 279 20 57
57 701 201 324 165 127 437 171 576 474 968 357 386 375 929 579 831 781 675 70
240 595 442 719 413 391 401 701 295 821 497 811 99 968 634 908 129 713 826 741
582 902 357 891 720 370 121 144 692 62 307 830 867 256 674 48 212 931 452 833
554 767 560 742 262 310 533 234 479 694 824 283 72 751 673 932 345 976 961 236
904 105 180 756 521 71 839 363 941 524 62 188 391 790 34 781 411 674 981 390
614 820 324 608 120 85 71 408 413 951 46 878 674 612 877 142 349 805 737 820
463 629 459 177 223 513 337 216 966 151 404 7 658 829 92 828 979 303 287 395
928 753 222 277 687 28 324 439 528 47 3 274 9 474 222 297 522 298 7 131
528 490 350 481 38 795 280 252 150 460 945 967 814 693 608 856 897 268 515 402
499 904 352 367 985 995 179 272 867 891 810 356 653 504 489 443 690 457 918 184
164 880 51 73 618 314 782 472 60 579 588 270 847 70 943 248 96 97 474 863
576 220 7 648 162 642 823 494 84 498 400 859 134 357 222 589 549 962 304 380
948 245 328 370 234 465 634 176 14 638 20 887 291 952 818 183 997 495 53 791
813 107 698 829 338 465 419 986 907 184 713 914 84 407 915 380 145 842 544 299
822 446 711 835 380 541 268 366 455 984 284 228 606 437 22 403 320 469 558 941
438 814 231 38 951 960 868 529 241 422 919 714 884 815 133 759 59 97 840 799
512 826 799 862 920 915 458 304 967 988 966 73 555 421 744 493 651 786 607 11
523 771 472 407 546 999 566 54 269 425 124 162 524 702 805 755 787 205 352 91
