20
974 699 949 439 43 518 605 15 879 572 805 691 830 358 512 885 5 257 596 853
760 316 596 163 130 770 462 912 437 692 674 78 382 350 661 808 944 188 75 167
616 306 934 777 843 213 376 254 302 831 998 294 727 272 8 179 181 762 60 894
233 983 164 20 764 4 135 24 691 339 765 854 585 838 178 288 257 668 828 459
579 736 502 675 996 294 673 243 126 266 613 824 52 645 370 12 472 337 625 57
61 341 972 389 679 925 537 320 237 529 83 239 845 167 956 306 907 1000 849 452
994 17 841 415 491 500 423 370 214 930 887 776 212 416 508 642 271 242 395 639
75 733 137 569 44 360 139 655 908 777 939 548 431 125 740 299 234 501 833 972
4 48 469 694 965 183 460 499 454 402 917 411 751 40 499 627 461 119 86 867
136 942 183 169 948 387 173 8 68 320 429 486 932 567 967 640 753 559 787 959
256 705 265 168 892 118 54 22 8 860 800 655 722 327 6 980 472 217 280 614
273 607 215 74 197 124 904 735 192 651 860 200 280 391 863 547 6 900 820 424
609 172 748 902 186 172 741 460 381 606 292 496 506 408 641 685 253 148 54 934
336 245 398 648 210 541 859 191 659 91 97 460 388 161 966 180 182 742 656 425
911 813 511 413 759 744 834 441 283 736 474 859 335 790 932 72 884 54 773 375
351 475 178 749 826 747 20 347 818 615 71 276 428 125 607 534 595 65 318 901
238 683 914 215 261 821 844 681 316 273 534 731 863 58 984 364 181 360 205 35
556 626 730 957 673 751 94 711 441 190 935 624 823 906 69 523 191 545 862 533
760 325 655 245 707 962 811 405 719 283 546 1 732 662 773 810 196 143 532 285
715 748 1000 776 591 354 916 190 941 313 458 442 819 435 48 374 671 452 362 336
