20
861 378 827 876 699 802 365 790 177 141 885 84 275 177 354 841 564 993 843 127
880 715 774 744 356 693 985 92 563 779 434 296 583 914 42 10 101 617 867 892
823 818 316 498 712 166 33 647 653 332 861 43 169 139 177 223 385 213 196 226
837 640 325 313 164 152 941 241 566 816 325 432 484 441 317 360 729 693 468 424
171 913 516 367 245 87 411 170 558 242 707 843 671 541 272 844 663 29 505 496
931 188 463 869 984 663 564 552 302 763 819 308 871 987 947 768 33 500 536 602
970 595 691 432 697 592 545 139 339 889 622 976 531 768 339 691 180 841 479 991
713 524 742 965 370 208 299 172 658 190 918 932 861 548 253 665 45 738 862 605
601 340 607 885 528 557 315 170 213 884 818 870 286 3 287 497 893 210 688 146
299 530 121 553 889 797 636 929 708 203 841 481 248 395 686 805 871 274 276 221
777 288 591 24 856 267 98 159 999 315 74 132 300 840 946 131 289 619 665 920
425 966 659 638 761 355 384 363 664 126 760 380 951 328 349 804 389 856 973 290
697 308 550 75 739 124 376 307 854 739 568 6 919 58 57 436 564 705 593 185
764 771 259 970 47 985 391 300 597 572 347 142 808 631 528 746 161 881 39 753
882 299 606 619 822 409 929 563 43 193 911 30 613 57 273 836 857 739 457 420
548 374 721 407 601 692 73 449 922 248 535 934 173 527 918 636 584 844 31 145
329 490 646 568 369 771 593 939 648 487 369 825 288 413 126 856 588 73 164 38
824 677 479 353 826 550 884 794 459 959 859 834 515 70 465 796 977 98 426 494
869 103 3 661 346 110 698 433 74 811 848 335 695 396 48 699 841 593 222 724
618 188 59 168 316 178 915 109 126 983 53 623 331 671 57 198 918 889 879 488
