20
507 296 33 958 246 154 804 977 265 196 985 720 552 130 923 815 844 637 820 319
186 728 312 432 975 369 248 83 487 986 403 497 580 692 545 887 557 589 80 829
835 355 994 37 746 846 333 295 670 266 103 747 983 841 757 251 661 142 633 633
23 496 407 249 639 883 858 286 455 442 435 651 119 850 2 452 613 842 304 918
470 969 120 181 775 404 891 733 907 605 516 788 493 643 772 190 501 239 264 895
973 757 498 61 940 656 980 814 642 716 755 460 283 873 731 775 538 10 601 861
334 139 659 488 617 523 122 126 2 497 697 859 651 415 271 416 541 645 248 993
305 754 347 783 879 481 81 327 250 41 442 491 618 382 937 599 332 737 701 39
750 175 770 779 926 469 532 485 604 208 598 310 14 371 526 957 830 69 658 374
672 430 366 652 481 510 254 378 822 824 582 416 292 435 944 659 559 983 69 15
102 887 649 207 502 953 229 959 782 65 701 582 219 751 520 752 252 235 81 166
230 949 440 798 869 959 209 713 24 769 681 479 990 1 315 401 990 62 620 133
404 995 781 552 531 156 567 186 797 149 486 534 786 541 684 276 486 771 954 145
293 997 481 665 159 459 662 725 458 223 438 725 394 448 756 976 733 519 594 499
658 347 780 493 41 617 144 194 433 606 111 110 595 951 238 357 141 364 89 440
969 28 239 303 934 871 245 880 964 808 68 298 872 846 822 747 528 213 150 592
36 678 676 253 265 759 447 201 949 101 251 101 545 19 198 263 530 334 763 462
915 618 559 451 161 765 590 525 148 36 485 861 863 960 171 950 489 90 477 437
97 905 864 18 662 452 27 533 837 776 764 583 330 621 74 907 147 258 704 425
100 813 960 713 367 871 195 519 326 983 657 491 104 754 450 959 455 594 685 506
