20
140 4 35 691 265 995 285 887 287 740 193 64 54 96 904 719 320 217 505 953
657 138 120 110 925 9 546 365 333 677 102 646 846 292 809 199 759 931 450 671
96 616 534 978 238 380 557 328 307 412 942 50 536 146 685 493 43 716 919 530
445 722 841 96 92 860 578 176 996 63 436 205 520 708 855 828 203 562 122 807
690 233 604 534 544 374 312 538 349 559 437 190 704 396 63 347 10 117 141 530
135 433 314 711 876 430 673 392 159 800 998 945 388 592 132 389 466 761 749 435
45 497 116 351 734 757 376 262 169 469 646 277 11 54 112 275 462 354 761 786
14 834 345 595 208 809 533 994 226 415 120 255 958 675 502 568 736 462 374 219
785 844 580 475 655 446 550 202 401 691 290 699 607 232 34 150 62 985 948 725
304 391 722 656 667 254 871 532 576 370 163 479 554 736 71 183 719 5 512 286
815 292 675 461 984 245 505 730 497 510 649 425 898 610 429 953 133 969 463 44
8 109 28 107 60 326 79 222 441 950 233 359 7 539 876 792 654 160 970 53
354 317 851 17 604 953 590 188 856 604 744 528 18 31 469 20 926 478 755 885
366 554 22 195 929 36 329 694 55 343 652 204 842 626 246 62 2 886 760 928
803 391 657 405 19 211 879 424 392 58 684 747 723 963 30 626 51 660 772 453
758 689 569 178 969 661 53 173 363 154 900 710 571 860 108 412 35 466 744 870
544 571 381 501 262 994 303 905 174 955 753 337 311 20 379 973 594 154 277 336
499 700 353 412 671 594 560 556 676 754 590 275 699 550 757 360 987 383 907 616
770 30 88 804 300 172 904 297 541 50 4 614 444 917 984 574 626 481 248 958
344 73 255 783 419 510 710 710 558 357 897 910 289 395 447 52 414 635 366 224
