20
600 620 871 313 968 59 535 982 182 439 479 347 940 166 299 107 114 771 256 503
970 132 419 544 675 157 337 890 211 749 911 945 173 810 602 12 722 699 599 391
729 831 350 379 384 264 281 377 44 869 252 872 324 565 425 137 490 158 138 682
378 267 874 301 930 205 71 608 867 15 558 436 621 610 208 656 167 726 333 931
972 842 166 121 346 389 751 174 92 936 975 589 599 762 834 36 123 875 465 343
204 399 187 347 525 616 663 451 159 732 957 342 976 133 600 11 712 170 19 607
977 136 483 335 284 958 253 749 585 975 445 417 544 133 24 27 1000 692 737 417
181 128 621 946 771 655 366 791 607 284 471 509 255 515 231 510 165 569 839 135
40 989 90 359 978 539 206 985 241 496 687 742 184 548 261 997 183 280 530 590
16 883 950 257 890 888 433 633 758 281 826 992 486 424 971 717 649 413 519 286
320 855 697 468 645 214 101 48 461 476 745 867 478 300 235 344 731 954 230 196
505 417 608 460 312 373 14 338 165 916 381 908 198 2 93 504 221 535 424 183
573 834 899 878 103 30 46 61 217 449 185 962 161 783 744 919 79 658 619 785
381 483 681 488 801 178 212 280 438 140 128 691 350 396 164 936 918 924 822 62
463 467 480 956 39 990 298 306 582 575 412 595 195 608 254 892 392 895 706 571
53 131 869 1000 623 778 826 392 131 586 717 563 581 486 146 796 616 262 668 952
145 132 664 112 164 63 34 314 762 465 844 96 858 829 280 123 448 389 994 449
658 730 490 124 281 209 162 803 742 727 897 849 637 322 887 154 593 909 511 463
452 313 494 896 426 463 414 335 528 908 167 914 915 286 505 961 140 448 273 902
786 93 549 52 220 863 717 82 539 344 136 227 357 306 588 979 360 979 421 149
