20
558 285 782 376 476 226 929 378 865 379 881 671 876 561 169 144 980 100 570 826
381 903 936 515 985 630 893 805 998 859 297 282 614 107 274 939 506 640 87 501
336 31 566 76 930 710 669 538 556 257 645 708 151 13 381 187 636 104 815 932
222 576 387 92 798 215 545 333 867 217 475 715 63 234 365 10 668 367 173 685
562 64 41 171 934 255 847 499 647 465 164 764 447 969 321 171 386 190 753 469
295 35 410 509 195 915 10 521 371 572 410 673 28 751 619 229 654 247 823 593
80 751 26 420 266 811 436 339 215 791 775 607 404 5 110 254 480 171 217 253
369 882 133 692 515 668 601 286 823 652 979 908 730 613 181 685 540 209 708 281
132 254 237 804 317 370 198 998 273 32 440 178 179 680 189 331 238 282 492 439
409 274 696 642 549 874 862 802 621 173 381 282 972 581 413 860 693 826 440 435
789 627 417 372 482 439 877 949 707 548 520 434 607 686 8 520 765 533 989 321
14 573 243 201 513 666 343 319 562 901 975 573 814 76 653 620 992 293 540 324
348 325 682 649 312 501 67 454 475 654 165 39 198 198 235 822 999 937 8 492
942 545 231 63 190 731 374 964 662 717 19 203 964 913 742 239 893 43 994 112
86 232 681 172 117 43 601 340 494 387 745 465 925 678 803 132 775 111 791 50
680 802 349 520 903 816 970 595 871 528 791 114 721 856 416 616 110 432 50 197
757 382 225 386 522 910 105 151 886 285 661 375 508 453 287 381 517 969 320 674
967 609 208 80 107 334 373 733 413 343 228 147 450 778 874 965 230 994 594 393
460 264 215 77 381 467 389 266 990 887 747 11 44 298 1000 224 601 623 99 571
109 949 534 321 200 519 508 435 242 30 629 947 300 634 838 726 270 71 874 619
