20
958 849 166 875 206 197 585 850 221 349 126 905 342 358 66 28 311 634 604 446
554 351 150 590 377 499 624 643 797 314 955 51 882 432 420 811 422 12 976 406
777 288 336 130 705 947 361 570 53 981 196 736 755 471 521 492 320 806 272 854
50 152 782 481 12 211 517 430 935 186 456 490 109 374 454 517 160 133 40 211
455 697 443 524 825 545 365 58 246 191 981 25 460 991 59 461 198 267 120 993
558 977 727 827 581 474 208 948 485 388 161 627 4 252 582 387 553 72 601 328
290 531 376 323 984 525 650 413 335 175 355 35 872 208 617 47 730 602 630 254
524 972 796 185 982 58 64 817 322 134 707 180 309 621 535 231 464 747 143 110
703 173 430 224 407 956 242 278 658 495 67 824 783 850 722 948 697 548 637 672
863 801 43 898 177 160 847 790 820 17 979 500 563 817 838 30 47 337 890 106
551 803 70 266 885 146 149 729 639 193 7 724 652 343 907 190 486 977 902 461
198 8 484 538 653 86 127 532 485 652 382 875 874 502 368 109 136 483 773 457
667 554 840 950 983 661 43 706 749 795 908 595 202 542 609 930 747 764 859 620
393 653 408 939 537 399 16 951 717 462 847 965 786 779 24 953 810 408 60 480
889 353 283 326 2 644 404 450 575 656 3 697 386 51 340 766 90 586 156 20
486 668 938 858 137 14 924 881 674 271 652 842 481 771 328 181 746 649 131 790
888 351 863 667 940 20 433 323 782 247 124 538 17 300 146 397 177 112 236 41
658 948 711 499 440 99 601 217 924 834 669 47 961 735 145 492 977 684 176 536
104 247 259 350 920 424 799 362 103 858 77 165 223 536 528 885 171 680 451 419
313 822 518 360 245 795 965 890 378 767 609 583 956 402 821 831 236 3 793 332
