20
451 470 582 405 116 556 629 279 333 237 224 635 541 160 448 59 206 30 579 82
945 497 551 422 346 228 756 278 662 697 30 401 144 47 235 562 253 458 137 984
671 337 500 794 821 54 792 106 752 478 931 719 347 815 487 49 719 363 512 277
205 740 56 154 228 286 165 404 917 17 333 291 929 982 312 486 668 412 450 760
723 205 652 209 983 702 113 697 555 241 115 31 762 838 259 375 25 419 613 8
669 431 782 928 356 43 96 970 98 203 291 176 256 168 549 463 457 797 928 639
632 778 175 954 232 80 812 783 501 419 341 470 707 327 668 239 687 221 499 898
602 271 820 233 886 650 467 959 109 777 499 45 429 214 434 387 308 623 530 117
969 677 332 467 810 905 243 150 858 340 363 987 368 532 681 371 252 435 986 734
523 681 269 749 965 316 696 619 343 797 372 663 327 171 148 18 551 398 562 227
578 269 921 786 513 961 125 150 254 965 985 640 355 202 704 929 431 659 752 387
748 226 35 355 609 19 702 699 544 867 358 691 289 324 818 557 838 354 15 735
876 458 910 100 636 856 910 276 547 663 321 146 547 649 82 673 30 622 958 501
731 482 985 524 97 44 753 433 934 775 869 387 431 754 968 907 858 651 366 236
929 562 896 487 865 424 309 370 814 857 627 162 457 886 484 570 787 674 264 318
306 453 23 839 295 516 559 251 92 192 559 90 813 987 783 723 871 73 476 400
435 976 587 570 552 459 348 112 915 645 758 582 641 107 603 510 568 221 44 769
954 140 585 601 700 590 372 645 723 900 275 300 538 822 321 912 314 818 714 816
728 421 792 509 89 544 469 107 100 133 354 503 343 517 511 404 67 491 380 504
535 305 7 466 205 623 281 85 444 153 299 882 832 379 759 201 848 383 407 289
