20
238 409 403 413 117 995 148 670 577 900 240 80 142 302 253 563 92 344 225 600
823 68 333 903 347 445 636 317 271 473 605 345 470 22 598 885 80 545 347 548
856 76 825 955 956 401 930 899 475 545 940 139 121 609 190 8 928 407 448 261
68 694 284 124 699 843 197 281 752 694 568 244 780 678 305 623 148 622 455 903
255 65 146 794 744 817 377 901 527 47 123 718 405 295 901 82 332 668 52 207
367 466 923 973 335 248 186 933 611 461 308 942 307 274 450 905 307 440 588 655
664 340 695 546 170 796 348 360 610 137 379 235 551 978 194 865 950 611 720 923
225 782 417 994 176 231 297 376 957 364 739 760 254 820 408 504 37 245 944 107
654 68 281 189 418 892 338 407 477 879 469 117 718 947 749 104 19 342 606 969
111 533 178 582 297 56 845 372 965 861 38 110 180 472 957 98 273 888 765 815
829 685 133 137 698 535 585 492 841 572 264 391 808 167 879 723 272 793 207 188
584 148 645 705 368 948 95 101 754 687 671 544 110 229 910 500 880 811 911 323
266 136 628 787 465 142 825 789 152 575 622 632 801 201 607 221 424 328 699 495
928 278 331 566 54 415 811 982 89 641 372 654 170 287 905 172 328 156 559 592
539 568 774 2 666 675 695 295 186 883 20 361 23 770 718 874 451 18 674 627
126 71 917 368 921 796 749 970 53 390 233 50 901 74 148 992 907 874 217 545
644 70 355 899 452 510 21 999 115 481 296 821 320 461 466 97 830 663 719 214
986 543 581 805 510 954 501 982 12 993 236 893 875 66 895 17 318 164 376 73
681 171 412 324 669 774 377 224 39 170 565 508 478 846 673 174 621 174 12 205
545 531 509 76 472 837 438 920 576 415 937 13 182 315 729 930 216 190 664 168
