20
912 194 481 470 414 528 291 330 880 117 288 876 815 581 831 145 113 355 617 417
250 198 714 488 767 229 896 794 112 998 188 643 819 344 885 243 740 927 44 192
866 282 13 338 295 613 207 317 709 104 953 920 106 239 71 368 31 619 645 507
98 206 864 425 859 128 552 900 336 205 411 806 80 339 871 462 832 925 841 960
221 851 69 92 851 198 352 143 735 218 983 963 396 958 156 507 411 520 420 494
997 894 92 8 956 75 449 171 157 364 617 849 214 406 258 55 146 612 212 631
984 722 793 385 188 148 800 509 774 914 611 790 544 104 746 552 710 84 281 348
291 257 252 379 294 301 103 692 818 872 234 171 496 211 460 706 488 549 230 829
644 791 513 813 791 767 189 483 321 487 103 243 544 828 469 890 775 545 25 415
273 743 951 151 640 194 6 771 430 358 289 784 912 229 786 777 220 302 171 251
484 604 774 286 539 460 218 795 160 868 468 439 115 185 435 884 555 434 895 904
502 304 147 142 665 334 308 628 760 961 322 901 243 154 829 536 13 333 840 374
983 774 452 566 669 456 239 944 972 855 569 304 208 716 430 513 271 426 495 271
898 604 544 163 902 242 940 536 635 814 723 849 215 392 977 657 423 555 220 973
644 745 579 503 928 48 300 925 157 334 882 724 960 801 729 369 398 385 636 263
971 240 503 278 331 804 163 186 399 172 694 770 730 678 663 58 958 26 243 282
923 960 95 178 518 649 319 296 86 2 288 242 26 506 702 148 327 835 781 120
957 932 985 288 693 686 101 493 408 574 611 308 641 84 472 193 157 861 339 821
67 15 598 744 981 791 152 828 61 310 577 732 376 102 456 512 672 437 171 262
827 472 695 964 104 225 130 280 318 746 403 804 982 252 372 858 668 820 946 282
