20
417 370 649 718 818 520 738 82 704 645 149 288 92 154 944 45 312 46 786 493
266 500 746 211 890 909 865 555 536 772 433 375 524 517 43 609 261 20 755 731
143 828 885 305 765 611 853 368 790 914 14 49 864 132 744 4 739 630 534 944
923 678 996 680 441 11 205 517 666 325 302 288 22 489 443 470 185 813 993 738
419 204 224 30 126 58 910 451 53 239 180 894 732 728 90 924 423 300 524 228
482 825 558 40 483 321 614 615 52 861 126 104 246 692 134 83 473 81 838 154
695 703 25 657 619 453 121 658 563 809 398 457 149 900 723 778 453 614 129 542
482 632 693 854 45 908 288 466 635 47 746 604 282 948 946 221 277 417 290 804
728 623 695 51 258 549 427 270 430 679 247 32 488 894 814 487 752 292 657 510
696 356 65 246 239 159 89 84 526 613 576 297 218 376 872 348 1 814 599 250
948 134 994 231 417 133 552 582 356 877 778 144 931 300 625 44 614 439 465 75
471 392 835 861 55 569 781 916 687 36 147 663 37 838 550 144 336 884 201 596
154 69 70 275 83 978 705 401 563 643 613 616 92 264 254 266 979 639 328 959
556 891 686 828 373 865 655 902 131 561 657 378 364 189 646 516 196 97 221 27
685 192 679 992 749 586 82 724 402 561 747 617 81 148 866 464 57 39 592 441
248 298 2 295 270 797 992 956 932 540 583 455 70 447 418 495 123 393 773 685
398 645 462 650 304 686 178 702 728 477 468 603 962 987 678 13 347 870 170 265
16 39 676 206 1 601 62 906 201 541 707 423 381 217 66 147 658 960 248 114
876 375 779 135 77 589 653 759 636 805 84 985 318 685 194 362 848 48 218 121
268 318 596 65 256 541 612 643 676 425 950 105 564 155 118 776 771 499 76 22
