20
384 158 288 735 439 741 363 370 64 499 527 724 266 191 442 353 504 554 98 33
436 754 945 844 53 775 3 735 146 892 329 806 739 152 394 542 935 445 846 609
737 828 532 308 957 98 229 326 982 497 263 271 796 236 178 635 124 417 252 534
862 874 487 742 935 623 355 33 548 109 146 476 496 12 958 705 908 676 629 267
175 219 128 834 122 531 19 224 593 411 279 692 610 994 75 605 723 589 714 884
878 464 699 524 531 524 115 839 211 852 971 330 391 169 607 262 513 448 242 132
490 517 614 864 351 715 909 34 928 131 676 310 709 294 447 934 309 218 522 244
794 587 380 983 891 737 479 822 379 380 735 806 564 780 53 852 100 681 150 502
372 761 2 546 932 707 555 759 983 312 685 752 903 118 29 624 59 830 347 379
485 689 941 265 682 497 39 410 587 308 342 958 213 708 785 85 445 898 756 560
700 402 332 890 862 315 204 438 872 702 789 620 469 431 926 408 112 160 353 943
38 740 856 56 883 885 382 483 336 517 420 909 625 839 422 995 364 837 667 28
265 313 345 240 152 469 710 164 495 872 911 503 842 943 614 529 108 984 201 177
508 885 704 963 607 61 120 571 253 343 175 358 533 563 967 678 676 234 468 473
647 267 27 848 292 45 204 633 250 330 242 415 404 266 317 656 521 719 948 257
99 111 429 701 678 105 26 488 999 934 995 682 429 21 641 195 652 161 105 153
476 567 724 495 658 366 340 445 401 957 986 459 174 42 316 61 736 587 729 608
562 179 11 779 46 625 362 559 730 691 784 691 905 126 126 704 300 213 878 465
885 751 629 110 653 611 827 749 963 997 107 499 326 169 393 595 447 165 661 7
885 609 382 749 35 222 195 457 792 107 789 847 788 213 422 85 498 157 755 961
