20
535 777 592 330 326 375 52 245 848 449 36 372 8 40 634 722 957 500 29 456
18 291 284 292 564 947 301 356 581 301 289 271 442 786 749 501 326 544 50 104
489 660 476 272 761 169 854 778 406 315 503 751 826 658 3 115 326 520 159 270
315 957 670 401 768 147 493 628 729 633 89 581 811 907 320 792 502 425 788 557
743 172 875 952 879 249 729 554 845 738 983 121 505 917 401 474 85 175 940 693
937 187 336 130 22 278 472 660 783 377 985 754 797 308 858 733 963 889 560 99
582 894 155 91 73 890 479 684 394 239 922 176 910 298 312 167 269 97 63 893
317 370 4 307 840 65 57 42 429 463 970 776 22 39 241 752 210 941 32 580
205 664 508 91 170 414 62 180 773 213 948 72 63 319 650 885 138 486 477 918
739 940 280 411 639 731 479 86 635 215 442 619 472 231 630 839 181 124 917 947
469 987 836 777 125 643 177 503 871 730 39 812 505 372 686 577 887 52 845 562
573 309 478 505 75 885 436 930 469 150 822 698 861 45 4 453 514 27 399 102
3 474 863 693 744 41 545 855 474 543 676 121 635 318 580 270 873 255 711 214
210 139 656 122 937 111 588 262 431 188 814 672 507 244 668 485 872 853 521 954
971 393 505 538 783 274 602 733 655 256 979 976 628 320 141 809 36 83 481 500
498 981 224 44 105 286 952 578 187 424 142 389 930 402 326 380 488 830 298 337
313 372 942 144 899 835 793 328 770 427 862 421 350 952 588 264 428 525 437 697
598 20 819 56 36 479 385 678 345 207 575 735 96 548 563 530 271 12 784 308
482 841 399 884 38 855 979 369 587 674 898 23 524 935 12 40 325 242 693 314
612 457 573 352 101 163 514 497 173 892 949 109 862 322 970 394 651 62 893 490
