20
25 575 160 960 631 470 774 666 792 905 248 870 449 839 862 917 31 856 895 296
35 510 812 88 21 42 225 52 137 821 862 514 885 853 385 959 426 774 910 128
932 59 879 443 707 589 879 201 266 937 665 801 945 79 154 889 96 555 802 157
580 363 307 258 712 719 436 403 279 540 993 701 509 140 736 900 749 892 290 561
167 516 869 182 46 13 252 255 448 824 310 190 727 604 66 928 15 373 37 462
754 108 934 973 965 175 596 746 809 634 596 414 672 321 548 326 889 916 955 315
31 436 567 404 758 834 442 861 773 157 514 428 239 265 720 554 45 474 599 356
954 646 518 136 682 50 742 92 568 834 169 446 739 283 181 679 21 116 221 838
905 89 609 873 11 23 338 765 295 16 576 856 41 293 510 897 708 255 417 320
533 755 160 843 828 698 452 707 282 516 678 485 532 984 888 540 625 41 725 715
296 815 789 999 591 607 744 864 636 465 152 208 597 205 663 101 70 309 957 765
232 185 718 883 881 673 918 52 26 426 149 152 929 462 863 924 883 443 544 883
210 483 907 209 225 285 556 189 143 149 452 142 168 90 941 639 755 867 568 518
662 412 884 157 698 975 449 945 817 279 106 373 114 494 209 378 708 891 325 935
405 244 550 710 552 867 393 158 948 636 100 748 216 392 2 189 327 700 540 243
304 3 623 902 113 965 20 879 398 789 274 875 77 326 429 841 307 550 758 100
5 631 12 764 895 193 151 857 503 547 691 243 876 293 589 785 350 350 874 551
98 317 635 623 608 251 742 62 770 117 68 927 586 78 431 326 401 841 639 642
968 643 538 327 609 904 189 934 911 505 467 524 314 28 488 487 854 367 861 660
316 244 889 971 835 679 857 248 367 336 430 936 627 139 279 612 682 468 626 206
