20
166 203 721 322 74 488 938 564 659 420 755 411 587 656 13 736 112 721 357 954
908 885 218 528 47 60 14 930 201 534 184 683 942 612 199 405 33 2 716 163
758 614 723 643 521 411 903 668 482 937 291 343 218 248 471 701 59 936 554 311
12 220 434 954 670 567 410 377 42 674 258 535 945 745 480 829 346 65 543 318
706 672 996 326 968 439 610 1 370 479 63 533 663 582 409 483 600 49 293 90
52 409 754 393 325 727 123 757 631 176 846 331 530 918 72 915 758 467 645 224
480 10 942 728 198 280 591 422 757 284 866 469 279 469 281 760 533 981 907 339
452 946 765 795 772 28 438 582 177 341 794 713 873 644 288 35 70 182 964 376
368 308 312 299 444 696 402 671 841 748 438 141 888 945 344 740 693 225 27 503
45 358 118 310 475 68 236 206 23 999 542 631 33 177 963 626 814 349 293 696
650 772 763 294 301 412 742 532 669 994 516 197 806 492 259 315 544 84 17 403
500 381 761 172 154 427 902 499 32 512 962 171 16 422 646 948 19 469 766 586
189 610 258 284 65 664 593 414 216 954 235 157 618 827 877 313 181 384 614 147
357 705 630 408 3 430 160 62 888 121 840 991 267 646 15 59 648 501 992 57
512 773 747 19 751 913 723 586 550 532 807 120 304 360 627 291 411 241 26 870
861 304 545 337 169 381 74 726 309 310 302 96 20 514 323 688 652 346 460 199
794 103 654 769 79 211 802 892 486 293 395 195 748 146 620 881 996 966 253 893
657 201 426 502 414 270 96 473 187 581 256 955 979 423 252 588 161 343 926 209
886 376 245 420 651 989 31 891 803 391 50 728 84 500 869 390 578 977 811 381
220 870 886 610 23 920 345 292 633 302 766 102 562 814 493 781 383 68 429 403
