20
864 116 854 764 197 468 681 554 537 483 705 990 932 947 465 801 980 849 581 718
234 970 702 464 380 546 924 883 322 239 637 788 42 688 510 142 574 105 292 900
918 630 20 541 140 34 147 537 535 134 433 328 814 616 836 784 607 821 767 912
343 816 721 710 89 883 995 937 902 593 119 761 889 973 56 928 428 286 826 978
299 785 59 781 277 358 516 498 509 919 742 357 273 562 460 516 377 975 11 229
841 71 248 144 28 882 749 904 430 753 922 937 247 128 950 365 524 693 660 518
402 65 472 363 919 631 570 623 888 703 594 119 819 549 832 457 257 573 159 55
288 117 7 782 116 622 684 672 690 269 356 986 655 167 366 322 333 913 467 127
275 951 978 25 35 525 661 601 337 594 587 431 856 941 572 835 170 378 753 654
291 94 111 563 315 388 402 816 333 117 839 513 492 302 189 300 65 374 907 710
145 754 647 918 403 386 44 999 369 244 330 841 26 769 120 79 326 112 433 225
744 106 519 260 849 604 694 419 346 404 757 846 843 858 469 208 49 351 683 671
48 74 713 327 586 560 618 110 237 142 643 666 471 413 126 658 870 823 233 362
271 430 10 790 150 659 493 560 167 376 984 89 909 930 416 628 509 818 249 653
472 38 137 299 625 180 180 312 511 179 124 906 802 446 305 116 46 396 921 665
685 279 450 577 847 362 600 848 604 759 319 933 234 727 482 959 254 699 564 468
918 117 476 315 43 976 33 352 286 38 241 773 252 368 953 498 48 801 778 885
159 976 864 661 917 912 501 788 553 958 786 719 541 164 884 430 547 213 303 999
913 650 245 690 861 786 948 284 754 870 221 576 696 210 82 751 150 226 702 208
75 253 235 796 518 359 668 948 493 986 961 165 293 395 696 786 915 221 73 181
