20
496 265 753 193 490 645 888 561 827 968 287 63 945 481 126 553 313 232 747 606
35 85 420 435 650 415 240 327 15 406 31 165 496 653 621 498 325 682 654 955
776 56 195 272 127 481 340 376 693 161 443 509 959 13 604 488 146 520 711 869
456 562 754 440 390 38 682 903 785 46 400 586 580 959 358 378 999 541 67 79
787 800 838 116 672 222 747 414 177 997 631 691 432 912 388 411 658 269 721 493
803 11 174 230 542 187 139 352 922 52 435 264 583 707 701 292 977 316 287 18
608 349 434 886 85 701 734 285 328 969 632 12 984 386 627 230 952 836 35 836
562 529 787 556 962 426 44 730 221 884 182 635 940 277 819 7 935 782 495 525
890 418 552 309 987 402 968 948 244 604 375 995 544 755 715 41 372 752 914 134
549 174 666 496 719 561 142 429 139 541 771 567 434 191 160 231 512 630 475 552
632 120 114 669 681 283 447 96 234 934 470 950 566 948 182 312 809 14 464 907
378 642 924 854 658 684 587 199 659 228 290 374 878 810 653 397 297 294 606 976
704 19 284 173 928 717 247 212 221 432 59 582 920 777 980 507 914 346 881 817
984 666 809 726 228 845 83 455 899 285 926 318 896 241 970 951 944 411 119 852
774 390 179 291 834 701 414 44 534 587 462 537 951 292 661 973 5 243 459 175
457 948 759 161 453 423 574 787 794 80 822 416 70 301 852 425 565 413 448 832
193 762 939 408 43 250 758 181 726 698 938 58 862 538 778 894 85 912 686 643
870 325 270 164 769 564 863 592 54 919 190 427 872 375 610 875 715 653 229 696
724 353 272 544 922 468 453 743 910 620 93 557 723 180 716 884 430 445 475 42
844 514 372 730 954 597 502 266 762 124 732 685 110 72 147 913 811 773 587 107
