20
569 420 270 16 414 678 770 369 837 942 937 754 784 548 440 226 532 388 892 948
35 393 334 738 130 618 688 192 528 937 117 44 705 563 341 377 569 52 363 49
251 900 240 922 772 286 714 404 777 274 836 40 305 456 200 274 55 809 331 677
808 144 943 638 658 231 895 438 544 905 289 548 977 959 301 585 373 900 175 459
334 177 62 837 38 545 553 248 460 268 865 76 590 749 210 670 48 669 140 123
87 913 696 110 12 938 971 19 690 349 226 876 979 878 977 13 617 510 88 88
849 900 247 605 233 991 732 432 534 942 139 781 231 945 879 714 548 123 97 192
233 15 444 104 436 525 178 127 669 431 237 962 638 671 486 472 602 163 619 404
664 792 647 669 801 80 893 942 962 484 392 301 271 141 526 655 795 884 512 593
320 291 18 359 355 544 510 208 353 324 358 323 669 693 405 161 306 807 265 761
297 301 767 633 507 334 334 586 475 68 634 59 243 557 948 383 697 774 125 557
715 374 334 664 348 320 999 3 208 504 371 381 940 515 257 218 997 725 862 145
471 785 46 311 472 420 701 667 837 239 513 851 371 329 784 312 530 491 422 763
19 638 1000 3 249 588 76 572 553 29 708 85 196 733 868 683 880 863 575 640
275 14 278 235 212 682 224 499 450 522 364 397 347 75 313 209 477 763 256 833
633 307 647 231 526 330 801 833 488 897 608 767 349 17 473 487 25 938 522 287
782 916 298 17 373 346 307 313 941 994 3 236 615 680 331 164 222 135 267 964
655 906 790 914 755 763 725 202 102 203 417 338 276 198 303 360 773 133 725 296
728 105 871 431 208 286 175 463 332 371 860 277 558 429 607 466 275 331 746 388
168 183 93 570 162 410 936 790 381 644 370 88 535 434 468 952 295 688 312 360
