20
917 447 33 68 886 433 211 670 207 828 726 396 728 87 821 806 403 208 187 818
810 264 338 467 64 576 336 4 415 450 810 504 591 367 796 572 29 921 147 790
496 497 415 729 859 38 446 30 759 508 507 256 85 44 944 213 659 41 672 988
351 176 80 390 834 102 57 301 361 91 446 668 649 10 10 404 285 709 446 624
381 332 650 54 325 760 170 514 615 818 50 361 355 311 670 456 872 447 360 653
813 509 282 383 794 483 343 549 41 156 780 497 237 454 966 427 884 39 71 840
966 877 918 152 805 351 848 664 274 656 764 539 955 995 37 893 949 974 669 672
560 475 169 583 575 349 238 481 839 112 193 900 456 5 962 98 922 650 437 136
264 370 91 791 313 93 917 913 751 174 63 123 89 863 627 575 465 727 859 536
204 858 596 711 239 269 581 238 122 530 446 358 773 217 622 260 510 892 624 636
892 384 125 891 139 408 904 855 246 141 459 740 68 907 519 540 720 682 16 835
146 361 519 966 496 636 582 535 710 679 301 948 483 719 74 513 213 281 692 421
451 140 391 876 76 364 32 713 32 759 260 230 292 902 419 1000 243 321 449 301
683 566 363 273 114 418 638 595 140 698 671 598 365 799 530 585 199 835 529 851
515 735 353 968 199 112 24 778 318 935 719 460 536 902 679 679 478 79 683 323
614 869 958 654 98 577 167 789 61 910 463 432 107 440 324 992 748 605 370 604
783 834 606 947 252 967 352 825 53 602 748 450 84 744 961 569 43 849 485 904
707 928 389 259 878 15 635 800 602 976 760 199 843 268 904 559 378 952 720 188
344 188 194 725 670 25 661 343 97 572 652 910 850 860 928 615 616 876 275 288
554 649 977 716 768 746 135 25 82 561 267 636 311 272 255 561 66 703 399 928
