20
863 388 96 797 197 841 787 360 416 872 826 827 41 295 587 711 466 799 346 3
974 961 858 730 984 391 227 894 227 351 223 309 123 528 550 738 892 63 574 113
672 755 748 961 937 128 447 196 671 468 475 634 795 913 64 539 69 129 747 187
985 558 609 176 603 96 603 540 98 564 181 218 780 317 208 146 252 834 623 380
546 466 966 263 942 757 555 846 174 902 493 927 620 257 15 975 54 627 803 186
76 997 351 249 387 663 300 207 652 31 793 801 71 933 930 350 780 586 964 700
133 756 737 996 136 516 791 34 759 73 577 319 854 871 533 858 165 987 438 102
136 647 535 183 256 908 696 897 711 210 506 140 226 441 746 623 171 744 937 875
156 411 703 60 31 146 49 50 866 201 242 585 341 126 493 435 723 382 296 644
918 286 94 281 143 809 983 681 816 265 62 199 738 556 422 954 180 135 130 495
125 328 507 964 319 508 870 109 346 430 274 936 813 977 263 65 816 177 14 705
761 485 575 99 933 14 372 945 457 354 674 509 446 153 84 731 212 479 324 721
584 1 483 192 353 760 916 586 2 720 327 595 195 623 769 485 72 349 713 565
377 801 959 983 51 195 808 658 528 750 61 30 938 888 779 966 789 89 734 347
664 615 211 271 456 887 896 243 499 170 706 887 247 644 829 248 750 545 252 471
454 208 767 544 482 736 458 899 340 394 652 276 718 649 707 573 469 627 593 228
914 465 437 736 302 383 452 810 73 352 48 22 548 187 116 786 523 638 468 846
516 723 952 215 159 575 358 833 98 44 896 239 862 679 241 363 542 868 147 72
554 728 561 811 74 973 348 143 540 14 287 385 107 756 265 987 925 652 911 713
502 223 419 213 494 486 301 396 770 398 7 841 54 616 547 743 80 509 571 904
