20
244 265 209 178 709 133 787 122 406 251 921 228 809 361 411 836 959 464 69 592
261 615 933 55 88 881 556 271 982 655 364 257 708 329 49 698 590 721 697 664
154 911 91 61 599 966 836 773 677 499 8 365 448 483 670 906 795 708 897 580
581 639 225 709 787 881 160 213 522 86 243 413 744 665 248 59 661 835 182 688
643 539 754 104 122 591 798 671 836 323 885 909 987 707 495 631 207 770 57 874
284 812 928 880 38 974 167 932 631 405 439 669 320 780 74 831 8 84 449 632
917 813 710 575 173 682 127 612 204 224 295 132 196 808 511 115 445 343 530 313
128 663 854 799 41 831 963 442 104 408 975 691 337 82 939 804 945 672 739 369
81 705 90 428 673 687 205 634 795 665 959 88 488 539 370 336 487 193 288 1
749 755 248 46 431 539 247 317 66 718 605 991 457 121 157 925 816 317 264 180
188 324 8 75 300 850 830 146 828 342 973 702 821 387 335 935 561 653 869 68
876 297 224 360 198 326 973 566 210 153 921 337 955 38 514 952 569 139 838 405
610 401 541 117 98 896 534 968 186 9 289 511 646 330 258 979 324 762 7 846
446 390 913 458 719 845 358 630 847 861 594 400 614 443 109 230 949 950 735 400
670 847 413 590 645 380 218 975 119 486 203 232 904 133 626 40 402 820 337 706
558 495 89 791 981 77 461 890 11 225 132 566 753 982 825 372 170 379 563 55
986 723 601 416 894 365 554 795 416 14 188 305 622 541 24 998 218 409 708 459
386 332 517 536 622 643 705 51 649 677 203 538 178 323 670 521 162 281 844 746
961 851 862 950 469 907 289 312 752 569 439 464 381 102 977 129 666 439 921 98
95 454 142 103 323 778 21 215 940 162 707 785 68 45 173 393 216 19 884 558
