20
909 910 501 536 201 189 241 974 223 376 591 299 522 261 480 875 98 881 593 601
234 673 455 672 616 407 892 638 419 540 877 350 167 169 742 551 673 655 693 292
869 121 487 312 217 547 948 225 321 48 93 482 446 948 281 800 427 839 219 13
992 447 621 102 873 792 991 828 860 995 404 477 335 287 490 785 783 863 256 295
114 156 971 71 324 106 407 545 759 662 66 367 873 772 999 975 403 458 852 210
632 614 108 922 92 823 746 892 842 177 969 613 889 367 170 262 166 435 642 973
993 153 659 503 256 114 943 488 905 703 666 682 622 620 426 145 763 746 958 410
974 321 52 918 523 140 925 282 97 818 470 577 469 617 62 233 742 630 394 559
216 790 618 66 204 6 216 554 527 769 199 320 436 113 571 462 326 845 448 450
354 611 894 355 199 351 70 293 26 110 277 234 587 182 52 691 454 390 69 108
868 342 321 146 597 901 232 289 921 585 910 645 890 555 24 458 41 866 171 481
38 538 998 976 424 346 967 878 852 377 917 843 491 929 975 190 239 260 340 436
727 735 503 994 432 885 753 729 161 350 972 984 859 884 874 66 414 955 261 554
425 852 315 760 2 677 704 969 919 162 866 186 117 865 402 764 254 18 876 556
514 990 335 525 637 836 371 842 998 830 515 671 411 461 448 18 779 905 458 63
162 978 382 92 602 986 429 823 897 797 723 243 946 631 66 340 23 372 947 617
559 364 287 927 256 499 221 563 702 501 215 642 918 378 281 346 121 376 205 612
6 37 566 971 389 755 152 270 388 167 140 896 155 481 801 297 386 300 524 578
560 598 902 275 118 446 979 500 77 579 658 122 14 571 141 748 510 133 849 227
778 560 312 229 176 442 311 828 426 495 642 360 34 904 827 537 915 249 108 694
