20
431 444 672 868 768 361 237 6 888 822 759 508 700 710 430 286 163 752 409 883
69 890 220 834 837 781 591 587 376 704 35 755 979 72 595 129 810 185 899 749
522 381 5 825 671 84 141 622 504 451 756 447 259 615 218 295 697 71 794 8
786 720 174 639 807 126 674 546 264 277 304 120 989 24 496 1 644 60 958 185
201 928 173 631 459 298 621 842 266 756 462 228 879 427 781 797 908 354 621 432
112 973 595 851 791 569 5 418 179 449 502 74 354 310 890 198 820 669 175 531
191 746 360 938 164 917 872 907 992 960 433 751 771 925 84 843 559 327 236 167
83 106 907 391 575 14 511 466 610 676 516 781 898 6 921 1 12 159 800 246
23 179 708 735 45 815 472 770 967 331 407 709 273 844 738 359 446 438 742 20
315 392 859 792 305 821 930 839 822 418 781 910 952 1 626 569 864 552 991 445
617 156 252 963 611 654 142 445 263 33 368 456 718 370 813 744 773 750 301 106
148 781 941 163 607 759 477 317 845 201 981 102 473 340 444 708 271 640 497 535
987 359 880 144 511 481 488 255 577 619 17 678 24 545 105 942 534 407 77 622
280 183 192 519 337 478 922 292 60 398 246 201 272 149 158 321 935 955 513 299
55 31 844 318 320 142 663 260 633 822 494 205 147 190 438 146 940 670 214 705
339 180 48 284 836 695 486 128 290 547 628 19 548 638 995 109 195 599 408 193
474 143 910 965 915 762 407 392 117 47 366 527 972 71 574 974 249 32 368 174
58 237 283 712 364 273 134 314 308 719 649 468 989 107 671 846 522 136 798 368
152 675 811 641 347 145 546 334 629 689 315 713 833 982 165 931 164 943 68 345
442 450 600 139 359 398 836 97 297 741 818 834 997 510 202 526 940 909 403 100
