20
558 762 707 347 90 766 495 95 139 745 300 752 589 902 796 470 876 530 92 292
279 386 310 145 936 740 347 365 672 445 36 488 212 903 322 948 306 674 317 172
408 868 736 652 735 796 345 352 446 910 678 383 139 952 248 468 817 387 229 904
709 59 892 150 869 570 695 631 637 560 218 434 871 627 401 820 426 780 788 770
676 954 69 113 651 172 731 914 489 844 598 260 807 725 104 819 930 1000 503 959
53 496 491 80 518 810 481 14 672 185 311 199 705 200 730 20 314 753 738 140
20 139 72 778 3 285 507 451 610 663 987 897 550 952 270 930 996 577 291 59
350 364 879 708 454 521 790 207 245 757 10 67 871 410 132 676 675 952 257 744
705 297 438 720 54 628 215 570 108 534 281 612 601 151 820 466 626 717 612 243
186 774 107 573 682 432 942 589 996 447 3 288 377 156 889 129 647 478 767 734
933 909 955 590 702 978 718 9 701 641 592 808 310 776 981 720 733 918 369 686
995 39 861 658 482 764 638 783 661 676 848 767 630 870 631 552 723 452 126 791
118 324 401 400 964 169 892 507 207 836 809 553 624 657 570 690 112 388 165 247
110 433 89 781 685 268 428 940 181 891 774 612 42 265 420 842 460 98 213 927
661 954 745 193 212 990 351 840 576 40 795 41 40 617 683 2 731 74 52 550
321 1000 784 110 289 21 26 588 322 570 554 73 453 333 211 425 859 461 189 392
987 5 234 490 528 911 399 942 300 119 901 473 441 490 844 772 34 703 351 70
435 463 439 421 509 338 101 467 468 435 508 564 573 414 698 720 509 883 286 389
454 425 767 283 707 431 719 416 338 920 366 763 327 162 876 122 884 985 490 902
412 693 277 777 647 608 517 604 633 305 279 582 301 58 744 914 314 214 763 570
