20
913 794 658 166 399 219 269 15 700 945 116 145 112 59 850 612 895 282 78 334
791 811 382 612 949 45 64 578 351 924 376 587 604 313 927 381 575 31 166 71
380 554 135 989 232 525 867 871 236 755 984 936 295 775 177 145 444 134 35 875
64 325 885 750 545 144 40 213 776 533 132 338 960 412 879 644 32 514 123 421
219 86 721 262 563 111 932 434 164 955 156 6 609 295 891 599 764 965 648 829
457 892 969 244 226 890 198 134 840 664 250 239 790 90 834 672 404 525 71 271
66 377 620 232 350 269 564 481 422 564 246 39 539 166 995 829 15 90 983 134
730 733 872 383 84 712 764 110 544 457 210 66 630 856 352 674 860 760 513 635
908 408 88 986 395 789 748 119 793 226 913 129 753 157 276 446 126 861 187 678
275 935 115 161 613 671 699 228 292 317 941 147 293 155 928 51 257 805 656 716
308 644 742 263 824 873 831 663 639 866 153 731 690 616 671 18 910 273 757 954
335 843 745 920 796 302 7 593 761 419 724 64 898 649 728 262 651 982 306 22
528 412 413 671 936 924 940 838 466 859 27 23 589 486 781 710 851 711 843 461
39 649 465 527 436 320 645 43 423 994 290 575 262 777 784 33 31 94 22 1000
464 134 333 405 896 776 484 226 548 31 575 938 896 831 286 44 704 347 7 808
931 747 523 371 633 177 50 131 179 773 318 603 439 149 214 356 440 498 312 176
427 751 122 133 111 522 554 704 404 809 61 934 223 596 797 142 730 855 241 41
882 85 678 3 241 367 212 436 906 984 55 753 68 491 500 160 493 677 939 421
236 46 654 217 223 567 542 195 430 956 300 739 273 636 435 338 448 502 542 734
381 602 455 980 397 713 327 561 243 233 578 950 451 570 610 373 132 145 545 278
