20
629 658 807 341 929 159 225 47 864 134 402 691 657 261 952 608 531 797 501 111
980 285 766 622 885 263 525 802 393 225 120 81 304 872 794 905 230 15 77 979
810 70 39 287 737 6 305 399 909 44 678 712 463 837 188 539 306 617 18 658
578 101 110 598 766 736 930 94 233 158 458 684 634 31 418 46 751 847 302 525
418 366 564 254 207 541 985 630 626 233 642 620 186 598 912 818 978 961 390 82
301 975 898 768 533 662 493 211 162 458 737 753 715 95 377 834 383 568 695 681
847 665 705 650 723 644 874 83 6 721 294 162 50 585 188 251 449 439 724 758
526 748 155 910 106 96 514 313 310 854 46 805 805 268 946 73 205 558 1 972
191 661 749 593 399 886 817 40 594 695 575 712 358 948 786 212 900 520 213 95
383 523 606 587 798 461 508 876 856 797 867 307 751 967 861 944 836 332 226 379
413 73 479 609 261 179 738 774 332 88 897 764 891 916 161 632 4 797 156 732
919 866 279 813 664 778 326 973 567 267 246 102 933 314 536 568 865 576 911 995
648 566 758 514 950 290 784 799 104 529 498 352 890 549 79 875 571 513 793 230
498 241 293 838 162 329 119 505 546 627 391 104 850 887 269 924 726 790 833 918
683 492 873 754 323 806 329 236 436 370 130 216 905 87 474 965 103 709 593 710
54 784 968 265 282 825 378 767 308 316 836 155 673 810 265 741 656 399 961 502
562 115 955 501 158 156 18 61 979 319 967 553 629 863 555 618 593 987 623 66
319 969 772 523 27 422 652 380 372 850 949 297 18 393 604 26 660 103 203 888
32 444 529 489 882 773 915 74 474 612 314 662 816 676 809 122 399 214 18 39
193 567 99 902 543 883 518 622 191 657 689 145 73 988 982 334 250 552 925 795
