20
252 494 807 539 290 123 128 984 844 969 896 401 955 793 393 667 269 942 42 712
779 710 959 911 266 440 44 171 531 960 244 216 576 971 831 799 83 885 647 323
562 938 347 561 635 695 763 103 236 32 433 33 547 926 713 654 662 764 534 722
457 730 428 139 88 51 656 884 871 104 854 86 860 188 457 912 255 563 717 268
675 42 772 474 557 998 369 119 216 322 155 909 413 435 225 264 144 961 168 340
229 999 306 605 607 94 900 524 969 485 948 149 694 151 122 679 12 806 705 98
323 138 501 733 429 636 451 876 147 40 39 964 408 187 557 889 26 840 706 816
989 874 964 266 597 236 339 711 676 386 866 423 973 708 296 723 619 447 630 830
880 531 738 308 260 342 404 675 912 44 923 528 630 638 982 934 387 771 188 512
441 940 822 995 478 532 502 615 33 50 374 416 922 425 565 952 455 813 432 723
705 554 918 115 597 129 758 288 869 374 552 653 650 971 148 529 983 322 589 494
242 149 700 669 291 315 414 145 495 46 244 759 746 839 113 663 46 84 520 10
326 933 902 915 80 216 301 663 530 168 166 260 353 31 951 579 662 126 750 789
356 658 232 316 267 421 816 29 731 97 191 589 804 936 978 710 924 992 487 680
205 426 944 940 948 474 761 722 500 559 521 637 743 173 782 168 88 717 807 886
273 759 960 376 702 215 81 874 303 575 280 216 570 187 759 234 894 457 656 907
443 587 215 542 847 84 119 50 242 202 965 586 318 192 573 949 943 310 694 432
38 776 903 553 196 538 906 467 791 858 393 842 918 788 103 85 304 228 703 470
422 759 403 949 844 529 665 262 379 589 789 378 611 483 25 913 773 830 651 828
697 885 851 559 820 778 632 83 716 70 92 205 901 344 663 896 521 227 544 659
