20
842 569 847 936 187 170 601 354 334 709 838 530 135 837 322 905 612 287 156 94
797 378 592 884 48 435 508 169 171 614 11 62 560 754 543 770 706 209 321 619
885 342 648 86 322 486 706 854 476 771 17 756 856 350 551 641 35 546 200 848
11 729 540 664 775 340 827 763 537 281 648 197 609 660 208 725 818 34 804 668
475 989 673 398 843 207 128 253 180 11 843 366 18 191 239 194 992 765 408 506
158 61 675 891 891 81 115 266 560 330 110 947 94 207 262 701 536 38 835 986
156 427 171 235 101 898 713 30 176 612 944 515 547 403 657 968 408 917 411 766
267 344 215 983 730 170 792 169 448 604 652 300 702 401 366 466 358 725 54 851
220 526 168 903 224 362 124 628 505 467 683 187 393 395 282 866 307 584 44 51
581 418 672 22 810 441 576 745 825 597 890 539 438 334 151 918 415 122 192 531
301 712 289 214 529 736 864 522 265 854 148 24 270 305 914 378 747 967 850 607
1 281 206 818 353 827 808 578 523 372 315 313 719 426 66 226 951 809 404 857
427 625 385 605 91 274 952 873 162 10 52 253 935 38 92 827 145 614 35 329
805 254 283 498 301 143 193 808 185 502 460 767 425 282 29 65 501 632 852 869
515 488 935 272 924 885 353 626 647 584 654 219 416 358 359 398 420 553 992 930
364 251 934 884 307 309 104 58 509 517 430 902 701 403 759 35 329 564 899 733
551 192 477 115 738 407 566 342 663 184 925 180 317 758 839 185 71 737 5 344
730 87 486 810 336 389 909 833 299 423 854 262 793 50 264 173 391 49 700 378
338 340 173 981 176 466 694 575 10 973 171 490 749 59 113 707 920 41 750 714
262 979 942 598 949 397 259 878 198 645 368 314 209 606 273 990 837 458 952 310
