20
897 756 489 49 945 200 520 343 588 534 97 235 145 577 655 348 456 629 881 788
788 21 643 257 1000 217 370 209 766 941 964 381 694 225 309 678 440 546 694 802
281 457 843 427 404 314 64 907 862 939 2 780 499 992 770 537 477 161 287 666
741 261 441 450 586 397 483 624 680 992 201 562 559 998 596 965 576 417 919 721
940 418 245 573 195 867 321 1000 128 148 915 569 139 997 438 383 294 372 412 902
274 867 396 104 695 15 453 22 768 512 632 930 602 430 167 576 555 157 398 677
560 340 773 884 87 121 748 823 712 901 984 94 289 654 535 378 654 373 452 223
832 6 167 698 524 135 244 359 589 200 968 341 638 345 486 309 380 414 398 135
16 720 954 781 771 653 802 800 759 129 899 831 117 147 244 998 372 35 420 66
594 998 890 291 839 537 651 586 983 296 10 379 125 4 338 2 270 760 736 389
892 45 514 9 13 120 549 896 907 912 379 589 501 193 861 751 853 314 491 871
926 836 946 1 391 130 722 186 306 22 968 692 685 481 250 647 743 3 562 389
945 138 359 780 347 168 728 472 709 942 892 90 789 215 319 936 511 624 422 595
180 186 369 299 89 212 771 330 599 615 893 605 455 727 226 967 597 409 986 894
36 120 170 379 152 313 130 579 674 153 118 863 931 45 443 364 857 737 685 395
34 382 665 795 385 225 202 860 109 207 509 173 73 510 879 981 145 834 994 478
703 615 598 480 113 241 291 547 630 722 645 222 384 349 899 823 230 516 966 595
288 682 787 535 132 309 481 371 607 726 927 855 789 470 510 581 708 102 694 566
857 328 332 990 490 692 477 471 424 645 223 686 394 44 178 398 809 893 221 991
253 39 530 270 680 759 24 903 164 693 127 93 271 551 501 655 491 25 357 131
