20
98 521 29 968 355 299 473 472 111 995 524 911 821 467 867 425 958 722 168 608
272 895 608 753 766 819 370 138 835 256 156 949 909 64 58 53 204 857 53 336
542 575 125 588 295 506 218 18 542 471 377 752 309 326 113 71 122 492 611 324
907 761 752 583 824 91 728 212 428 323 725 109 424 887 178 781 421 743 25 87
903 508 276 299 74 492 536 629 340 590 769 58 242 451 981 457 372 706 269 230
746 285 781 551 678 445 855 228 552 928 587 186 827 407 828 842 661 683 564 367
283 656 178 623 740 848 751 929 1000 280 829 706 451 192 426 150 88 146 922 193
911 218 591 259 704 380 487 175 122 288 175 186 923 668 314 127 57 795 655 307
157 62 832 973 31 979 937 658 468 764 998 769 775 772 908 621 8 749 420 576
914 351 415 89 88 755 716 223 647 575 12 712 32 769 313 815 510 426 982 546
429 235 633 822 988 229 557 228 401 170 315 695 794 928 90 865 983 760 628 765
265 206 634 288 305 458 322 959 690 377 66 713 558 773 342 217 976 573 936 910
784 275 318 574 625 435 857 183 130 28 793 436 434 263 155 853 265 995 82 365
493 234 204 180 316 98 117 746 675 281 680 710 617 467 162 416 775 638 923 323
452 580 467 916 864 836 446 610 995 224 486 895 381 624 167 51 508 756 470 913
87 947 472 216 251 152 882 708 655 981 244 796 26 396 437 21 194 307 159 851
283 939 676 225 536 441 194 596 502 498 145 772 148 206 281 709 776 887 517 815
602 692 778 611 107 596 83 746 778 329 183 48 896 920 519 468 333 401 389 118
716 495 42 81 318 132 361 524 306 590 41 302 186 452 559 862 666 605 354 507
923 265 921 736 263 9 857 284 876 663 33 259 300 883 482 915 125 224 54 623
