20
581 378 701 920 53 609 790 728 614 517 525 383 728 11 871 596 156 325 514 998
382 1000 280 725 342 934 666 887 447 171 651 465 764 124 778 529 990 565 849 696
578 562 178 512 621 77 287 3 845 654 502 239 856 981 174 737 628 903 38 12
903 722 916 556 353 607 686 53 232 656 794 743 808 726 63 70 790 442 435 43
867 968 981 330 813 745 507 474 319 808 758 904 992 265 139 534 739 819 99 585
494 939 503 465 874 526 630 117 56 351 352 368 980 585 765 88 880 56 683 536
721 549 842 55 27 89 112 346 367 721 967 743 402 884 772 596 311 924 347 199
845 268 659 353 212 710 25 175 367 878 343 745 526 100 930 904 664 173 73 458
716 387 771 147 440 730 726 971 84 568 788 706 309 734 65 708 35 905 98 807
960 477 510 187 60 433 207 794 840 4 833 674 360 602 612 438 332 774 486 48
236 205 436 298 697 366 737 105 469 835 249 484 686 107 808 262 490 802 775 540
492 648 232 336 894 20 220 878 427 557 238 21 439 107 78 486 737 322 727 847
711 27 372 119 253 109 699 46 113 706 688 308 752 473 160 733 441 258 279 749
31 1000 282 848 834 26 675 194 853 110 274 932 599 332 543 801 301 453 635 581
56 375 986 660 493 623 14 384 149 985 115 495 697 828 875 437 787 554 107 955
185 513 305 581 92 950 994 616 150 473 167 854 133 143 619 770 473 650 24 599
382 782 78 364 506 71 421 134 527 480 468 254 285 582 320 847 809 95 509 898
499 154 350 376 285 238 518 254 897 434 97 207 868 555 98 942 122 325 268 389
378 47 789 207 453 147 583 415 631 335 518 175 787 299 2 224 389 855 478 952
109 995 576 902 642 985 977 96 361 200 689 978 248 491 138 863 865 329 815 272
