20
221 993 606 690 808 745 805 880 844 555 745 636 253 788 473 981 311 399 366 635
718 645 176 947 143 703 944 615 792 817 831 610 246 677 237 959 649 791 533 80
156 517 675 977 651 26 959 621 1 456 135 543 569 907 352 459 656 21 427 859
871 92 139 856 853 907 185 431 825 928 414 304 228 738 854 104 346 749 530 234
381 433 948 599 440 618 927 396 989 815 902 307 596 848 989 715 855 521 282 209
14 912 511 348 913 233 125 566 69 778 308 359 421 153 522 815 533 878 614 720
7 139 782 471 679 683 982 14 301 377 898 277 689 192 222 899 939 258 844 950
955 18 801 987 993 778 975 302 661 828 194 692 852 701 423 262 124 354 763 436
463 127 500 187 621 407 774 45 913 527 776 722 612 685 187 24 829 581 674 329
815 181 600 42 481 95 691 999 189 981 960 863 155 131 427 445 710 904 924 28
531 375 225 346 74 397 525 871 475 981 150 799 563 269 980 483 408 412 436 855
355 606 979 919 564 728 72 762 950 47 77 543 760 534 601 20 214 894 967 432
260 997 283 414 522 840 616 829 348 638 191 886 458 785 325 223 250 814 785 557
655 141 606 944 276 658 662 367 833 768 722 536 544 22 773 547 800 120 790 726
159 982 868 774 367 604 581 208 345 291 519 162 795 379 505 215 30 400 733 20
675 182 66 835 8 538 799 718 921 138 642 981 143 986 176 831 789 422 305 627
832 426 521 492 779 470 914 302 471 392 290 694 507 379 286 939 301 647 137 581
238 965 549 923 68 414 802 469 632 476 519 865 283 425 516 807 461 551 963 971
767 395 882 661 954 290 852 400 632 861 940 664 361 614 45 944 833 797 36 175
747 553 731 531 974 584 884 283 377 264 867 190 911 216 756 336 110 778 448 359
