20
138 891 788 251 928 371 616 959 482 784 839 883 516 746 273 580 488 460 422 561
993 721 131 112 103 44 718 176 323 530 445 763 355 52 82 883 346 215 712 997
668 162 332 765 384 272 976 940 698 654 731 912 12 683 350 900 792 42 361 788
256 703 363 849 783 5 630 306 914 874 64 565 367 240 44 33 285 565 613 294
867 580 552 671 399 177 233 320 666 203 558 709 731 742 585 350 848 539 97 693
148 105 216 147 581 173 703 824 487 932 26 448 390 772 126 551 300 896 765 862
963 610 104 706 783 51 385 54 109 588 267 15 423 762 54 712 497 875 344 388
281 116 588 489 198 443 1 449 686 838 194 493 559 635 19 752 507 988 566 545
100 558 281 929 292 478 861 948 104 303 658 746 106 44 913 185 628 840 671 76
123 930 769 769 27 194 240 637 287 840 195 766 394 811 268 559 997 588 459 210
100 278 297 278 200 676 856 320 749 665 773 334 161 814 317 138 736 753 128 247
237 610 369 479 79 274 876 840 225 552 811 205 416 321 438 326 510 454 639 959
263 766 468 990 89 331 401 372 659 369 482 912 172 895 117 983 123 484 614 104
205 730 100 218 846 863 606 307 535 958 759 266 103 782 609 715 125 808 976 896
959 406 289 753 952 422 713 945 879 932 583 412 31 509 56 411 887 934 352 749
564 457 425 449 231 107 568 128 738 247 339 100 362 134 362 23 152 731 881 61
911 608 805 754 226 21 543 505 280 332 223 89 171 741 437 771 221 626 878 812
78 961 761 815 305 237 572 827 622 398 504 463 667 795 981 93 734 67 686 535
854 722 482 734 667 806 30 923 68 487 271 381 696 29 552 773 920 163 907 758
952 288 535 977 907 883 374 666 34 389 522 161 476 64 500 850 796 390 119 606
