20
432 57 74 72 439 410 649 235 436 221 899 429 881 438 508 965 181 254 770 857
911 146 629 654 340 507 265 185 249 115 718 374 208 570 534 182 955 409 82 753
219 431 234 71 886 660 26 556 504 301 429 247 517 306 140 231 439 690 682 662
944 418 632 35 867 91 756 417 982 721 97 841 20 770 102 137 195 972 601 912
892 633 261 495 826 209 724 419 613 863 334 795 35 203 646 108 40 631 506 730
19 516 689 901 26 868 151 259 415 572 249 140 399 589 126 160 935 756 814 258
819 141 155 222 548 136 865 932 249 244 64 159 756 551 514 527 504 277 480 602
599 135 929 427 539 612 230 423 597 201 527 314 860 283 693 648 659 833 730 194
814 267 949 223 246 254 436 392 413 665 405 932 849 728 285 815 630 755 856 299
105 329 800 202 44 457 782 310 606 854 70 621 618 366 275 882 557 858 399 392
287 721 655 52 86 572 162 459 59 863 194 610 934 556 280 364 168 511 159 11
165 743 465 750 726 221 427 278 459 459 364 300 956 18 504 577 523 719 429 625
775 771 443 297 863 211 43 610 153 739 674 301 141 410 908 688 284 803 388 286
965 900 675 523 239 177 616 995 764 128 1000 41 406 885 760 286 833 312 326 386
654 935 668 630 229 27 216 574 130 406 194 87 941 341 664 331 765 841 976 11
96 367 28 256 928 561 386 108 720 441 981 804 264 482 927 126 698 443 866 24
154 160 818 268 318 633 39 735 70 333 622 22 267 776 788 172 62 617 781 919
70 827 760 640 351 616 248 108 932 488 43 688 503 84 832 659 400 241 456 728
123 180 535 685 795 421 989 104 681 669 417 198 580 236 865 53 843 416 817 109
893 837 105 7 660 629 763 149 680 559 421 208 629 396 108 564 189 292 905 776
