20
23 951 494 950 893 489 42 17 418 772 690 155 694 677 840 976 933 864 237 903
450 804 933 544 840 540 477 457 309 361 38 927 744 592 57 74 39 918 163 214
543 779 297 889 732 564 633 397 967 807 809 503 303 516 902 315 152 322 635 557
622 613 678 777 402 171 800 632 531 327 347 942 535 18 474 706 598 409 826 892
407 272 768 502 580 68 320 108 991 477 700 909 57 531 560 258 270 968 247 403
6 954 587 742 87 794 928 45 202 650 688 736 474 514 341 372 295 349 179 509
853 377 126 939 594 804 558 502 666 334 307 974 729 461 325 154 634 901 393 33
323 477 621 179 244 679 40 653 279 423 944 12 388 504 821 549 812 24 942 113
579 239 111 100 995 585 998 26 545 626 680 859 378 728 651 881 923 432 934 968
182 763 917 208 856 446 525 534 722 535 273 554 475 738 922 615 480 741 327 171
327 24 266 791 779 451 782 896 34 316 114 791 908 157 976 620 497 321 108 729
23 943 33 123 607 426 955 106 434 105 73 535 333 368 580 725 524 161 935 70
544 735 374 916 794 92 22 236 142 711 936 246 778 495 931 994 709 318 355 215
170 576 385 59 944 893 886 776 578 273 194 59 203 364 319 679 778 258 92 761
928 566 894 450 453 807 538 796 84 786 102 139 925 985 277 227 785 792 909 86
881 83 664 567 969 913 814 687 291 354 911 827 42 186 284 182 539 359 187 662
125 846 614 408 482 975 583 288 84 999 165 103 11 393 573 1 16 919 961 892
603 229 401 671 730 758 914 37 854 514 549 637 80 710 92 970 722 388 96 563
2 812 20 531 844 456 368 306 755 942 968 553 794 195 28 674 273 539 192 362
645 682 954 557 227 113 607 742 682 769 444 930 590 359 294 531 482 551 247 338
