20
524 756 525 458 981 16 731 40 328 426 920 500 809 202 587 250 879 353 484 428
438 718 105 809 816 668 366 56 456 665 26 923 758 732 141 605 204 172 338 227
671 288 897 108 409 866 740 391 421 703 509 601 805 890 820 315 846 713 206 806
478 967 582 503 766 119 910 329 204 714 59 58 675 653 84 368 615 307 396 749
576 149 856 929 252 143 125 406 270 687 195 988 888 167 872 164 432 838 470 320
942 608 745 983 240 972 548 831 457 523 272 972 651 941 704 36 492 734 962 663
56 757 305 685 110 200 772 772 971 461 327 978 508 835 123 862 79 116 171 630
775 672 968 211 636 948 502 750 762 300 735 522 496 403 946 532 963 43 747 522
709 539 926 97 21 192 430 410 963 848 29 137 674 624 508 400 361 993 292 864
7 218 555 632 719 885 245 737 100 867 396 48 596 137 360 746 438 141 716 246
995 238 712 547 700 231 438 622 894 636 915 180 767 810 502 620 589 174 818 953
401 281 722 887 328 747 802 542 608 524 894 740 627 147 436 989 585 208 980 919
857 151 516 443 713 439 511 332 187 631 600 180 428 733 212 119 268 201 124 170
47 288 597 911 455 77 50 570 149 49 177 539 904 595 955 230 670 819 583 195
545 989 44 355 212 623 515 487 395 506 46 766 631 528 961 692 252 925 453 275
948 559 293 685 445 864 760 455 446 726 817 386 516 741 407 176 852 553 59 376
905 71 171 225 959 902 407 792 185 261 821 873 15 498 781 668 58 118 182 99
791 610 280 33 553 608 560 398 239 2 322 303 717 914 263 403 777 955 959 84
647 128 188 343 996 850 403 333 613 509 491 363 11 89 541 656 758 573 96 862
594 45 958 578 645 384 757 496 685 160 450 406 165 978 83 960 815 455 262 974
