20
979 141 919 623 903 325 761 120 678 881 12 215 639 63 482 991 817 261 904 6
6 676 974 938 647 266 334 298 615 84 506 912 884 798 252 49 230 720 335 775
497 96 70 107 171 109 555 394 359 6 719 762 523 959 634 907 481 701 467 363
730 126 940 114 345 941 550 158 814 260 923 175 25 630 736 637 922 462 82 926
365 513 201 685 276 135 160 96 50 822 927 413 247 638 653 371 749 709 722 97
337 584 602 89 694 381 676 104 228 199 661 387 164 695 205 989 875 800 24 102
837 108 99 645 393 259 994 192 315 338 115 983 609 984 441 684 691 673 630 28
178 346 203 996 380 189 176 446 357 494 539 19 396 102 261 844 412 345 769 778
363 997 633 41 538 131 367 558 30 292 409 110 884 862 771 676 984 20 840 909
574 268 928 708 970 852 719 159 313 579 901 141 104 61 627 955 435 504 6 841
996 681 539 116 399 908 268 681 743 121 787 926 522 611 457 161 289 775 593 949
64 646 525 586 341 389 686 491 163 878 651 517 174 405 46 976 626 524 652 241
929 358 27 54 527 82 930 116 40 896 962 200 71 30 844 26 860 187 308 647
878 355 795 104 750 516 727 914 901 982 33 886 720 896 414 177 654 119 114 163
736 38 431 402 409 533 346 41 646 78 197 757 409 649 685 885 471 413 39 36
785 414 393 441 868 893 24 89 629 573 703 503 924 135 584 189 972 271 354 941
28 477 863 760 821 612 697 68 549 739 381 642 961 380 732 388 859 662 598 571
508 667 883 761 154 79 738 456 954 549 207 755 735 397 883 213 344 973 561 910
695 279 49 322 190 658 69 807 867 590 680 597 331 40 826 642 759 248 821 286
427 573 777 750 601 775 94 74 313 935 836 10 893 680 623 825 270 975 591 191
