20
83 225 766 134 985 621 899 496 847 232 688 207 908 581 841 213 640 171 246 422
994 263 28 772 384 586 806 603 457 127 16 817 685 450 795 945 814 429 662 853
884 592 22 937 622 240 403 562 565 22 11 10 460 856 234 608 977 205 633 685
690 927 247 307 818 209 824 443 423 891 636 779 710 865 479 108 655 102 623 604
105 55 336 234 1000 204 748 164 248 851 598 682 680 681 105 200 327 64 819 885
97 184 734 827 657 687 436 882 693 103 857 455 22 512 725 631 782 616 841 428
860 820 361 767 294 924 295 380 169 908 699 156 211 503 177 322 565 648 588 793
189 119 807 471 937 618 748 194 455 521 365 944 944 824 859 260 902 985 572 873
990 821 195 66 652 487 270 94 327 627 512 734 647 339 699 127 927 733 682 988
50 631 593 149 505 249 668 837 853 28 791 842 491 389 810 239 477 502 606 972
65 802 359 246 168 528 870 166 261 733 891 757 418 156 203 215 967 525 723 846
739 382 586 216 889 137 221 180 150 991 489 839 233 271 260 167 744 965 341 896
358 484 850 556 169 745 728 434 283 965 599 914 701 345 925 50 750 908 751 533
920 23 772 992 44 364 204 131 173 119 564 520 814 687 811 473 786 625 365 457
65 538 870 556 480 4 454 986 181 266 51 974 32 582 492 80 132 834 913 873
318 902 34 235 127 699 783 682 631 962 416 469 48 787 40 363 664 91 977 944
600 806 243 716 458 478 936 782 361 487 56 927 435 605 367 892 729 304 703 861
61 788 477 378 620 423 962 220 997 16 469 871 844 925 283 607 377 312 116 235
417 503 804 760 459 592 986 802 619 682 555 313 908 455 309 707 132 752 98 849
81 368 7 203 660 761 420 139 321 344 895 196 442 886 219 293 580 879 821 197
