20
256 4 871 270 633 384 281 305 808 233 773 365 759 357 442 983 852 327 411 414
397 440 123 900 136 571 978 593 659 142 73 194 104 756 47 866 184 168 388 219
473 52 60 954 31 518 213 569 520 495 709 434 981 602 614 697 771 332 604 457
713 406 284 958 928 845 475 545 945 495 408 127 800 249 53 48 392 160 621 674
353 150 915 287 675 158 786 812 160 634 97 498 997 847 324 931 383 673 480 958
217 25 347 215 269 447 278 690 581 224 997 928 379 838 436 351 754 339 24 99
107 455 784 24 798 467 68 572 379 335 362 759 232 963 231 6 587 82 536 53
524 796 185 417 176 251 154 740 165 366 60 981 2 534 72 126 908 672 879 968
543 98 352 797 408 997 347 925 331 747 820 980 827 236 13 714 891 399 451 903
582 531 380 325 51 476 414 625 665 945 56 586 701 871 247 49 254 510 71 593
725 499 878 716 574 517 182 628 337 742 642 166 484 789 231 230 928 110 168 60
283 924 499 683 133 626 312 130 742 390 16 285 877 895 355 813 746 158 491 425
927 852 611 130 98 132 296 267 920 573 46 298 166 630 516 963 676 621 537 567
257 566 113 820 244 465 616 170 964 753 623 601 944 383 635 534 851 28 793 385
745 756 167 623 717 974 524 993 676 704 494 265 375 133 623 418 734 216 943 740
798 791 105 911 232 224 631 251 903 850 720 316 819 282 342 883 36 497 107 571
972 880 346 278 64 624 55 38 612 696 992 31 423 138 975 233 815 836 314 237
452 867 361 438 204 667 152 57 893 966 786 226 673 397 694 256 927 756 266 897
399 62 89 3 727 236 25 787 589 40 997 307 665 991 730 57 867 604 200 53
401 628 304 133 478 830 171 951 353 120 426 509 92 756 632 701 666 949 214 55
