20
551 390 315 468 22 93 337 451 679 509 25 301 296 352 73 38 633 297 792 411
23 252 126 600 880 725 345 961 469 206 412 62 354 141 167 574 324 102 644 498
89 210 315 283 275 962 812 342 684 155 425 504 403 969 831 313 384 854 185 610
308 628 114 818 365 200 413 397 319 601 88 190 522 714 776 961 273 660 840 555
836 63 463 319 216 4 237 147 836 192 576 365 739 638 25 180 145 361 900 100
667 852 333 501 122 702 953 952 87 141 153 409 830 885 22 165 214 545 473 143
243 584 775 158 737 107 962 484 977 700 402 883 481 497 450 13 493 61 80 794
472 911 543 156 139 580 41 952 495 345 754 955 518 582 146 240 664 538 727 787
262 627 676 709 805 869 777 924 929 518 903 123 646 441 945 16 893 126 617 706
303 927 592 428 154 994 657 425 676 520 908 786 705 405 807 20 807 253 132 421
327 210 587 667 710 361 58 886 962 587 620 453 112 338 641 10 251 263 375 55
259 289 544 40 995 428 349 473 195 874 99 235 28 64 472 524 641 899 634 925
255 153 894 812 168 658 377 489 917 746 638 868 414 623 422 762 789 749 768 734
408 263 729 266 69 615 170 196 467 575 624 771 802 344 168 521 858 464 904 229
354 389 900 137 741 179 393 25 252 928 491 971 771 94 146 283 573 203 352 461
31 878 381 313 961 687 572 698 180 804 599 722 322 127 363 386 926 242 156 906
647 815 305 5 460 733 840 439 289 141 669 784 762 19 559 284 45 669 577 60
904 416 689 484 625 755 26 593 70 67 127 444 376 35 435 497 881 892 731 137
504 836 354 244 252 377 372 240 382 34 967 360 347 640 343 98 622 673 437 399
101 418 655 163 566 918 413 837 950 636 646 128 776 121 411 979 76 298 290 335
