20
743 519 765 681 193 463 291 832 720 542 955 980 669 928 781 474 754 822 414 118
871 320 466 485 539 849 493 617 387 885 14 293 853 951 229 666 645 754 13 800
37 601 954 460 279 364 367 573 822 613 958 74 193 362 885 603 908 841 329 537
575 252 648 284 676 605 564 543 368 331 943 676 674 424 283 574 671 736 214 361
766 621 301 187 176 505 988 234 830 371 87 83 647 930 400 213 921 426 536 308
82 476 393 985 648 169 414 29 298 478 26 903 973 128 689 654 72 293 225 655
597 549 465 645 559 39 634 411 698 748 149 266 854 845 191 811 29 536 173 472
742 279 858 353 970 398 401 738 672 666 711 39 494 939 592 729 273 358 672 328
148 579 537 923 244 454 16 129 400 688 101 864 976 949 131 899 809 826 369 826
6 775 959 696 703 798 882 16 56 583 898 183 475 236 331 786 196 414 408 197
396 424 65 140 218 215 566 871 256 563 425 502 519 300 942 49 787 557 987 589
971 245 658 899 671 150 12 381 115 316 764 953 849 984 15 942 287 434 788 10
347 72 312 958 423 28 564 152 533 257 427 959 360 892 804 889 202 39 61 579
448 239 536 587 43 860 702 503 68 226 451 203 867 317 373 755 697 892 437 183
710 599 730 837 998 441 233 482 341 59 705 628 251 474 913 220 222 972 847 811
718 944 90 841 109 263 790 767 513 705 163 709 504 464 472 462 505 90 186 20
174 15 190 519 996 419 485 106 883 339 16 697 743 279 991 383 697 195 115 748
909 26 174 734 892 340 878 294 550 736 112 135 322 168 332 676 17 659 63 241
705 672 899 670 187 875 505 732 946 878 953 912 192 631 193 232 321 375 680 929
536 55 834 532 435 850 814 66 855 843 549 750 390 604 804 180 146 684 806 174
