20
160 148 938 481 956 69 769 739 832 758 377 936 725 200 16 599 231 148 811 185
944 56 165 805 197 127 904 516 922 521 729 949 358 15 917 745 654 29 765 651
695 285 296 597 579 989 910 202 949 346 172 400 90 489 122 857 886 611 502 587
926 601 317 533 691 625 555 321 676 812 652 83 225 670 978 758 493 321 927 363
196 392 72 111 743 477 70 216 90 776 618 595 506 198 712 996 83 305 443 573
879 370 687 503 122 141 49 538 688 833 314 556 936 691 946 728 597 62 432 68
656 507 736 416 668 204 829 57 225 285 403 710 885 450 36 86 312 913 636 332
491 56 482 94 109 934 926 394 935 650 273 579 139 758 810 225 351 828 337 973
996 857 396 738 815 346 581 475 452 334 821 717 944 718 643 914 641 985 184 505
672 986 407 164 982 645 818 630 485 392 486 612 566 149 789 110 503 755 621 771
213 783 618 426 46 131 115 153 913 27 303 136 886 415 809 245 91 897 642 537
320 968 905 822 843 319 189 713 65 30 965 568 159 772 685 976 251 326 194 756
189 574 753 347 245 195 408 403 370 451 570 669 582 617 216 673 629 7 510 328
712 879 318 228 227 905 20 780 35 836 787 159 370 111 194 64 351 110 876 16
35 372 484 38 854 93 272 669 721 101 391 660 65 956 451 160 6 460 138 987
369 855 893 307 928 682 316 134 693 713 435 20 563 388 186 642 575 110 965 562
237 725 285 731 487 424 806 782 501 966 843 436 528 701 544 799 760 632 257 738
775 937 278 773 406 873 932 561 711 828 981 160 716 233 9 158 632 273 563 774
100 140 569 265 116 494 247 604 877 253 432 517 784 738 935 186 215 508 998 918
227 959 46 726 337 812 318 898 939 823 543 543 65 173 719 530 174 513 244 891
