20
567 186 825 624 449 728 398 781 72 187 596 639 836 103 76 387 557 522 204 343
475 43 276 885 841 68 132 504 620 437 159 465 176 554 538 786 38 401 128 353
29 375 150 172 938 787 924 35 326 227 734 868 762 893 442 834 463 932 524 397
271 464 168 702 820 786 812 871 902 144 694 264 972 254 7 640 62 533 944 828
637 945 383 477 145 286 109 173 825 92 847 604 366 616 570 545 219 953 733 665
195 671 839 326 860 910 873 580 220 320 503 724 531 291 238 710 700 885 948 637
232 840 716 155 389 246 406 827 63 495 775 70 768 617 423 546 693 241 577 860
491 931 229 837 764 926 132 90 576 599 113 258 441 291 346 373 15 315 876 367
414 227 177 62 749 33 401 77 414 219 742 241 543 866 870 273 775 63 44 890
139 859 948 880 551 24 335 498 481 463 840 884 219 266 321 271 40 968 537 260
773 442 303 294 139 739 494 687 42 3 213 968 474 129 315 932 828 666 461 171
377 902 720 90 391 532 805 394 588 155 698 360 461 901 103 686 697 709 745 617
93 195 212 176 581 403 734 941 835 320 142 823 92 102 974 614 973 918 77 96
754 282 161 309 452 249 838 904 494 686 99 935 306 778 620 859 866 406 195 516
419 566 79 282 764 406 579 896 659 504 125 744 64 634 97 177 749 779 386 257
527 658 967 279 572 652 322 124 277 140 496 115 735 938 189 527 554 365 292 474
876 927 655 392 999 167 905 380 982 200 622 648 940 262 530 955 390 918 895 692
841 735 449 52 803 455 266 613 791 242 257 67 933 227 600 651 393 396 296 488
554 885 299 905 398 369 431 937 833 462 930 657 726 862 380 649 530 766 211 382
281 403 60 749 219 470 405 243 218 183 110 67 413 918 3 568 661 758 75 569
