20
287 105 592 489 268 791 664 523 705 444 798 416 481 488 252 793 929 708 66 350
90 207 155 635 550 30 559 847 329 150 398 999 59 839 483 18 742 993 192 676
897 359 274 334 25 261 962 295 956 329 219 285 695 130 693 324 821 381 16 643
553 28 834 553 834 58 414 506 488 579 860 979 423 911 709 303 142 481 13 893
747 186 345 564 960 165 245 384 252 740 239 391 661 739 972 789 404 332 221 862
510 384 442 972 679 320 426 260 765 652 421 327 757 793 738 616 413 95 68 14
893 94 189 640 656 646 996 307 20 476 219 138 262 426 568 560 26 101 271 870
763 26 2 589 938 74 635 505 431 716 594 251 348 435 954 180 370 758 564 283
638 661 250 385 199 475 752 781 369 559 225 659 803 428 62 537 302 9 139 188
97 450 652 86 48 709 921 207 532 67 624 874 497 923 333 558 716 357 367 232
496 447 337 133 290 720 572 1000 337 267 924 524 87 989 868 713 254 78 127 709
2 638 256 988 94 938 108 232 389 215 823 279 245 95 611 264 37 650 87 46
399 587 822 783 179 86 686 263 450 104 275 449 28 234 133 362 344 652 892 190
39 541 400 246 780 507 220 308 296 685 589 141 12 57 963 732 132 658 770 610
348 89 36 289 159 639 369 398 307 346 436 397 821 867 905 925 948 634 271 485
968 900 299 801 453 796 778 657 23 500 391 625 228 1000 724 547 455 576 890 863
290 966 436 221 762 766 939 839 205 479 70 155 416 325 565 999 251 817 765 175
529 859 316 279 442 726 894 574 837 808 199 541 430 558 249 203 814 697 895 743
900 90 394 925 679 643 890 165 475 928 784 108 196 599 718 425 170 669 637 321
278 21 644 101 883 11 499 316 811 483 596 593 773 896 762 698 71 889 633 375
