20
740 773 177 264 30 663 669 920 542 363 129 671 269 198 158 588 689 886 983 964
752 857 115 978 833 233 151 652 641 212 674 307 887 73 842 391 282 284 429 112
684 993 321 375 234 928 259 755 60 915 460 690 641 72 134 186 245 634 261 108
24 379 570 419 940 1000 602 36 745 278 110 523 349 238 692 725 548 900 615 267
716 576 106 214 516 468 925 130 503 731 548 929 803 941 263 246 34 546 787 670
958 244 203 368 167 430 874 965 987 206 962 844 139 988 836 926 696 443 691 538
957 488 898 573 410 917 688 115 214 946 536 556 855 652 973 872 516 75 2 17
372 574 133 104 745 399 934 665 427 100 421 946 686 314 39 830 991 484 516 118
236 295 581 16 123 597 338 15 150 912 815 678 102 633 273 531 350 483 235 240
562 384 376 582 315 158 789 578 845 711 374 119 779 214 801 943 765 901 702 478
928 249 970 860 401 182 989 908 496 795 76 261 670 93 132 958 40 645 755 119
842 474 762 763 97 25 960 31 825 551 619 670 603 973 54 758 956 21 557 224
266 84 561 945 614 500 574 130 449 236 964 411 806 548 313 406 209 370 187 407
503 689 499 480 212 772 996 972 453 53 235 800 592 725 657 50 771 64 86 493
569 44 294 738 739 580 622 618 75 601 794 791 648 212 290 220 817 110 292 861
588 742 978 483 951 780 273 846 666 302 921 373 931 832 506 978 237 343 739 68
625 191 303 854 831 756 327 771 126 223 251 190 390 762 508 559 956 236 442 308
159 100 760 300 150 824 931 106 813 799 691 689 308 47 818 695 927 612 722 678
200 574 185 564 267 351 715 954 721 77 706 178 474 492 271 479 451 851 556 271
185 434 597 324 252 686 632 33 432 575 982 412 722 793 235 173 268 579 223 460
