20
452 264 670 291 843 671 50 180 574 374 6 203 193 430 38 237 582 859 207 884
445 428 46 499 228 304 491 691 60 612 453 458 369 946 138 961 628 675 853 370
655 591 919 291 852 511 70 335 823 116 895 524 314 147 852 996 472 498 763 837
957 743 281 414 69 671 249 96 50 799 755 939 141 50 274 603 6 672 468 749
911 352 453 305 818 689 618 186 282 623 850 47 788 149 289 532 378 126 941 49
156 781 13 416 212 558 894 859 32 895 545 339 375 893 490 828 729 915 331 762
33 130 588 578 473 691 862 33 3 692 210 147 681 791 173 268 522 769 510 850
377 605 787 644 567 488 178 63 450 271 246 291 140 391 22 275 885 110 502 433
498 614 161 208 506 425 601 559 294 660 651 705 873 58 332 903 324 174 564 795
925 741 793 131 929 668 496 628 633 552 67 840 575 231 379 902 243 115 711 896
393 383 378 268 532 445 913 966 951 41 588 186 503 925 908 4 689 840 926 557
254 810 97 480 372 984 354 531 310 908 727 860 308 648 977 651 687 342 3 902
215 171 45 408 996 608 459 695 698 119 67 390 365 836 312 809 461 509 875 124
9 461 126 798 241 979 874 536 113 924 313 300 461 662 833 147 145 116 437 681
659 692 865 526 712 65 239 63 334 829 115 676 109 959 323 836 576 429 495 639
91 531 665 527 585 129 613 793 318 770 340 799 481 978 529 285 923 318 87 314
712 501 296 551 349 695 465 83 655 497 722 351 726 280 326 560 593 80 679 999
83 365 62 927 393 366 4 742 382 182 543 5 727 369 381 523 758 882 980 416
324 632 94 505 242 428 293 642 266 377 665 606 758 302 642 202 98 734 786 491
553 85 344 825 978 277 13 799 116 698 674 877 478 89 932 526 2 199 413 309
