20
899 732 398 130 416 236 31 469 522 553 98 768 24 106 889 482 492 56 483 536
886 294 955 178 954 594 338 835 345 621 348 808 618 233 518 165 202 509 32 229
378 659 792 831 731 690 740 453 951 87 575 687 378 711 512 389 526 558 286 292
566 733 761 73 57 378 178 510 453 78 169 104 373 215 723 412 97 275 292 907
502 718 270 210 894 369 508 659 468 939 692 288 625 160 225 755 17 774 768 95
378 447 274 635 34 394 616 987 84 691 39 824 821 402 320 619 604 848 300 664
558 482 138 936 66 356 669 336 916 859 974 833 415 157 188 378 275 733 481 345
920 45 950 102 83 920 815 854 683 378 807 560 77 196 431 541 178 511 480 711
8 386 184 168 242 434 378 119 632 295 505 728 19 599 268 192 167 14 895 796
162 348 462 346 642 728 701 750 417 510 212 497 469 941 108 560 125 62 560 751
695 585 726 994 538 975 996 755 372 3 736 737 593 81 78 183 793 84 681 339
632 198 654 660 371 89 350 205 397 741 303 853 493 614 511 717 902 923 431 656
785 10 44 209 320 451 871 28 587 35 202 956 201 322 632 53 644 628 513 551
16 750 520 559 315 675 30 388 608 28 968 4 676 532 441 205 583 418 845 136
306 548 824 797 255 222 540 337 685 414 642 655 436 78 653 363 637 326 854 346
851 587 323 506 907 361 764 629 235 108 722 726 220 934 811 581 717 597 807 129
87 747 986 948 142 386 440 751 337 896 976 523 707 616 807 808 360 595 360 88
214 821 485 719 594 363 372 499 354 59 196 990 254 191 656 262 908 902 203 654
526 665 524 696 954 201 807 751 955 404 252 713 153 715 779 493 72 45 78 670
896 882 75 398 307 780 843 53 268 436 835 222 471 165 274 724 452 187 651 441
