20
540 606 913 882 175 39 148 228 779 216 444 761 241 210 3 727 704 708 875 807
346 500 531 198 792 513 215 510 867 768 799 229 742 468 171 474 686 620 256 794
682 358 474 359 701 399 746 835 329 126 107 545 985 652 714 916 818 234 493 532
603 861 366 548 111 978 940 610 603 837 264 965 280 399 798 931 572 279 288 735
137 261 831 654 831 294 576 290 234 546 514 609 623 229 279 110 617 962 851 904
419 21 55 744 571 575 681 464 66 617 36 772 28 533 477 454 120 495 194 208
756 911 171 593 952 365 908 447 88 781 20 778 374 597 356 192 771 511 417 911
502 794 954 58 930 142 791 708 442 988 346 365 190 2 377 812 649 586 323 428
998 875 148 625 944 784 493 867 149 488 738 313 108 268 780 353 377 196 511 836
151 141 495 716 306 247 898 922 63 812 457 623 988 200 264 439 102 266 344 762
96 399 65 283 810 423 668 443 311 243 652 434 801 243 910 704 389 407 314 471
75 710 779 350 526 499 993 686 63 882 337 838 817 799 222 629 128 730 231 578
932 5 154 765 517 156 340 533 505 979 817 837 236 124 588 772 622 862 300 28
536 349 571 578 887 492 161 59 682 461 623 575 635 374 340 515 502 35 773 559
367 288 968 561 539 21 72 629 710 722 719 46 509 218 522 381 412 470 1000 845
27 915 397 140 16 606 249 833 754 431 467 158 230 688 357 787 16 217 99 650
778 566 647 169 430 890 961 490 119 758 508 594 987 623 911 842 258 247 971 84
817 744 591 717 659 852 997 988 38 591 158 922 55 654 120 643 380 410 572 916
657 785 411 970 776 684 389 576 298 511 721 710 344 710 655 231 427 249 849 222
75 950 350 93 463 751 57 514 224 58 16 714 562 725 441 392 416 477 910 592
