20
680 967 197 677 994 510 867 251 159 122 458 43 415 547 749 157 91 108 823 625
717 492 549 137 489 247 353 880 631 453 795 519 691 384 627 512 407 438 760 233
680 979 174 261 793 963 498 938 37 194 234 136 268 512 553 561 45 890 901 657
605 41 16 766 101 144 840 806 14 356 888 24 557 198 229 936 982 423 764 224
272 610 792 127 991 254 387 293 339 126 761 575 238 744 528 523 600 170 126 554
636 665 232 991 993 606 605 800 728 655 440 158 442 572 89 280 776 215 955 966
752 670 552 187 151 553 98 765 1000 840 186 761 266 617 128 185 39 593 42 851
699 588 191 455 473 724 616 530 384 987 530 422 631 148 853 462 991 414 273 561
847 531 499 795 845 519 969 782 509 823 375 243 907 120 427 700 822 485 640 201
810 445 219 58 978 339 768 44 700 326 682 415 568 863 999 224 143 342 573 258
525 239 454 440 910 891 363 131 196 80 168 460 284 529 679 571 374 879 498 709
919 381 175 794 57 9 291 856 725 408 449 541 933 699 912 716 889 484 916 937
962 72 325 340 176 976 937 56 275 667 981 770 198 986 491 105 74 701 779 268
939 264 474 423 252 537 635 907 327 506 109 951 843 972 457 768 253 241 733 753
397 891 523 687 812 172 285 258 404 624 284 417 864 967 244 226 546 281 932 159
65 226 377 881 875 328 948 337 334 591 448 897 889 637 573 55 215 354 185 140
426 540 421 893 980 304 753 794 136 73 797 315 971 12 837 262 536 492 254 986
511 797 729 823 344 479 272 107 212 315 716 225 694 302 702 903 999 836 443 775
433 201 386 23 46 716 75 827 100 750 382 843 906 200 12 913 729 253 829 437
496 172 374 930 833 612 869 814 96 320 122 76 450 588 563 973 731 434 118 90
