20
688 809 14 351 274 913 635 391 386 778 634 754 261 865 693 603 308 809 80 695
338 688 262 347 829 180 458 985 959 233 800 208 307 437 255 941 722 22 941 609
911 209 366 57 277 362 981 146 65 161 433 26 526 586 983 941 719 559 712 575
704 622 355 773 810 1000 338 663 848 67 515 615 27 610 90 845 273 165 276 563
468 95 251 394 774 52 133 449 949 251 153 794 225 149 146 657 462 591 737 266
371 318 291 147 141 869 435 959 109 266 17 651 878 661 628 793 49 442 147 157
912 356 366 562 767 913 155 844 945 267 853 613 130 878 725 805 452 409 529 743
374 774 564 641 414 98 427 505 82 616 760 563 717 157 269 680 988 383 544 453
514 399 511 821 809 591 448 478 559 224 236 693 664 55 13 47 461 407 806 746
885 790 80 841 982 257 79 385 474 864 964 414 294 729 471 25 687 144 326 608
379 146 471 933 494 229 293 290 73 732 378 501 458 900 336 268 831 438 269 615
299 22 140 13 831 517 348 628 330 553 672 243 407 920 516 197 204 255 823 764
593 167 787 815 970 986 575 738 207 801 309 912 886 416 159 446 906 670 441 972
276 638 239 312 914 353 673 856 30 232 848 991 696 390 98 532 245 724 856 671
358 468 599 885 973 595 93 831 393 781 22 171 274 22 293 48 840 990 832 564
188 629 419 882 815 344 18 434 556 410 15 956 546 490 148 85 370 720 29 487
617 203 870 830 431 412 993 329 855 272 632 807 882 479 401 889 534 305 171 914
690 368 171 157 709 838 801 947 415 869 343 787 883 532 44 734 485 35 360 233
351 404 624 301 557 985 994 709 508 7 631 302 623 300 53 254 894 553 318 503
8 404 751 596 431 372 371 310 870 121 484 511 590 843 320 199 743 751 19 355
