20
104 557 3 358 731 874 162 724 79 235 104 96 849 680 144 913 878 832 669 234
388 557 725 261 485 742 486 265 742 553 394 733 785 5 765 22 648 145 932 433
622 817 709 275 191 218 538 862 675 716 27 166 83 29 16 229 528 882 409 427
421 318 123 547 341 541 430 825 557 234 934 45 782 14 415 593 837 380 758 690
669 836 739 60 638 170 717 59 827 47 883 906 375 97 780 111 509 413 182 275
522 980 147 564 854 864 863 906 493 608 97 187 320 227 688 421 737 179 309 44
20 402 518 22 754 574 777 301 241 689 945 362 58 281 800 416 443 932 351 989
143 820 843 472 109 924 157 119 412 399 981 981 61 303 313 41 83 36 467 988
421 248 668 571 122 847 584 321 106 943 479 601 861 384 563 198 716 522 81 130
128 886 335 390 200 708 766 771 790 817 892 692 985 607 966 644 710 497 87 153
707 392 990 665 965 971 969 255 296 494 905 738 148 940 485 132 547 749 119 259
172 445 156 905 811 55 759 550 424 983 455 454 99 961 903 950 984 71 48 842
811 192 140 877 264 614 38 110 217 767 225 773 592 39 909 930 114 733 687 312
136 920 779 420 770 802 713 1 413 533 523 165 67 496 89 549 6 341 357 659
112 758 370 800 327 986 41 713 672 389 410 62 286 935 336 378 772 533 375 490
667 187 944 44 409 464 170 967 418 290 995 945 281 625 8 930 556 896 892 561
615 767 572 625 529 586 500 91 763 685 44 243 696 407 521 101 344 450 934 442
534 526 864 465 456 711 585 843 289 525 648 430 391 419 696 61 568 98 295 349
443 656 525 989 51 774 281 151 338 739 2 411 876 716 711 986 423 561 713 267
172 178 763 468 879 884 478 957 640 235 531 262 808 903 663 888 837 17 888 872
