20
197 520 975 107 390 805 414 132 712 119 470 26 624 231 348 184 775 972 305 51
800 310 474 401 786 644 449 236 505 851 759 804 313 433 686 239 377 372 268 467
973 931 763 867 12 129 823 431 255 458 303 466 183 423 564 356 173 953 577 774
585 428 21 792 475 273 853 59 906 473 357 915 502 494 34 534 819 623 50 721
543 796 974 112 52 697 316 386 753 113 515 564 269 691 359 900 665 496 325 629
648 134 206 367 604 383 420 953 712 253 923 211 74 799 968 140 800 426 197 356
669 774 170 692 507 285 737 93 290 840 50 652 736 773 681 780 46 877 488 782
500 252 286 539 509 842 204 90 831 156 805 858 84 733 392 399 915 278 634 767
646 949 296 542 672 924 396 108 71 987 842 351 403 67 734 699 910 712 580 349
610 958 757 4 442 852 414 220 920 517 563 410 972 453 842 749 498 565 836 225
562 907 533 280 859 332 827 462 699 18 691 148 30 282 936 935 679 877 770 888
487 403 349 289 754 375 353 372 239 943 500 444 769 356 498 309 892 905 644 33
840 281 757 183 335 760 937 225 693 765 91 487 797 662 770 737 995 573 811 67
998 482 414 534 214 391 633 917 291 95 380 169 431 3 497 139 615 639 117 857
434 204 932 963 510 670 66 636 99 305 855 916 707 951 467 974 748 806 610 601
306 694 789 703 507 820 590 247 35 704 998 851 636 155 650 474 198 98 114 480
861 362 768 480 841 383 990 38 421 352 980 44 15 262 435 464 632 109 896 993
98 636 972 735 647 669 13 984 679 706 611 548 668 100 51 226 988 666 978 285
947 952 467 9 803 460 675 582 746 27 981 645 959 498 88 582 600 87 278 754
216 62 63 46 855 429 48 242 263 591 856 678 976 327 703 193 957 769 226 286
