20
468 433 770 489 18 457 416 752 100 766 168 108 871 330 367 52 24 767 505 667
767 793 586 333 673 334 27 298 40 186 876 488 94 575 334 706 588 281 218 518
318 266 318 308 893 553 468 861 861 613 398 412 553 978 526 830 355 387 743 188
328 840 525 716 887 491 813 593 303 312 885 703 599 453 266 788 643 793 148 22
557 999 893 988 232 522 881 330 506 799 924 113 512 782 53 964 778 464 843 450
272 582 916 230 722 886 40 145 27 75 346 12 805 996 845 422 305 949 12 100
180 216 151 839 209 362 381 268 847 669 436 415 455 408 332 300 25 812 193 473
247 11 667 680 477 489 956 416 311 443 466 866 17 919 716 674 2 572 331 702
284 579 128 415 213 201 245 659 911 739 206 343 872 927 118 157 245 227 46 138
585 334 331 71 834 68 635 59 759 618 365 253 792 39 423 928 517 32 673 80
141 163 179 564 236 44 717 392 756 829 759 892 596 127 957 233 339 973 31 831
893 569 39 568 325 724 186 431 572 273 407 29 6 668 271 25 338 674 511 419
457 536 843 724 669 273 368 341 226 188 795 63 128 181 117 43 303 225 452 507
446 935 483 315 671 685 333 348 586 492 500 500 342 833 822 743 112 567 588 594
500 149 950 80 667 308 155 447 241 748 574 811 931 583 515 780 158 264 819 38
635 809 355 851 280 717 502 800 974 513 89 344 106 769 331 52 370 693 494 806
416 891 91 327 896 407 994 779 677 251 934 589 575 28 11 603 504 88 796 381
632 979 168 945 506 2 344 312 810 28 775 913 157 581 590 124 351 339 356 603
277 926 7 183 874 150 39 921 944 417 440 21 625 19 542 271 594 845 160 869
391 333 581 808 759 748 892 2 830 199 645 913 622 385 555 18 316 980 492 326
