20
378 726 507 138 533 825 517 57 334 993 775 345 638 684 263 937 902 645 844 324
424 698 384 899 422 753 161 604 986 95 879 942 72 390 860 404 321 56 169 477
480 576 650 594 693 334 461 772 15 824 271 83 269 586 346 909 278 217 762 963
605 221 540 671 913 427 514 277 176 656 778 485 964 398 262 137 199 815 29 462
623 602 127 289 629 414 98 378 516 968 324 559 405 40 260 941 916 358 93 13
175 648 834 667 61 544 919 503 152 152 176 451 247 546 740 424 229 481 209 753
11 795 440 510 810 300 332 104 741 150 623 680 311 636 891 430 333 196 944 605
610 209 428 192 990 910 91 13 164 345 588 112 922 939 620 238 144 601 715 93
759 672 749 375 655 26 933 385 4 515 872 427 288 288 950 548 682 777 620 270
72 833 930 235 366 803 768 621 556 184 910 585 818 423 849 712 24 59 893 398
536 120 641 247 351 827 794 346 35 782 103 828 81 258 407 974 953 830 374 773
863 999 864 652 419 988 988 10 155 772 202 650 233 718 777 975 617 423 765 803
755 447 544 846 758 415 202 566 132 41 518 345 652 182 564 313 382 481 871 679
734 838 394 126 469 763 776 99 173 488 449 637 769 990 333 335 311 239 544 337
254 717 99 316 634 951 683 55 919 586 96 14 148 418 314 743 303 994 362 917
305 89 850 428 604 225 457 943 619 27 405 915 932 536 323 522 139 740 259 896
546 679 260 201 161 461 255 353 121 751 406 880 948 408 149 932 365 414 990 348
816 773 982 85 877 305 797 997 838 804 977 518 610 817 835 713 788 541 346 188
959 359 404 704 934 856 764 351 158 504 657 532 85 220 515 592 80 90 58 695
644 178 592 600 703 879 61 713 649 726 422 230 744 465 276 198 572 221 984 554
