20
351 560 579 59 265 958 24 823 488 877 75 397 468 178 485 585 459 783 564 511
604 178 491 76 53 540 569 374 619 39 200 327 259 472 876 545 789 515 27 290
874 329 988 996 776 620 79 808 978 125 521 613 570 635 419 828 433 45 322 965
249 464 118 999 112 621 89 714 924 712 473 165 920 983 946 502 885 793 56 360
277 742 856 500 748 959 699 707 300 735 223 568 320 474 187 632 686 830 830 861
954 62 296 928 142 245 414 421 914 910 899 23 68 78 344 938 765 282 457 408
777 324 397 279 599 917 993 370 733 354 708 942 442 961 23 677 576 738 684 284
175 543 713 335 993 231 971 491 587 247 139 140 414 884 688 527 917 272 336 76
131 809 722 573 864 160 795 680 442 991 817 107 20 552 501 858 486 775 412 898
37 737 149 662 244 132 153 708 486 518 648 728 147 508 478 663 19 133 94 211
84 348 21 246 268 293 805 113 396 346 976 654 163 199 649 587 117 621 759 721
743 324 531 203 994 75 818 698 119 720 309 120 47 256 664 57 979 831 42 703
13 948 381 553 659 921 437 856 243 558 79 420 156 233 223 685 144 144 640 772
487 796 913 427 21 248 48 1 601 840 976 383 102 870 49 301 547 363 41 919
571 300 840 879 694 931 239 922 969 698 560 389 725 165 25 7 602 337 155 284
388 830 278 805 518 240 617 793 512 87 96 410 78 972 993 843 875 958 89 134
652 836 679 775 298 293 520 758 221 343 427 656 404 602 393 991 370 594 587 247
900 946 305 123 457 510 568 614 265 920 305 639 772 922 159 902 459 926 701 488
828 518 814 609 466 145 666 64 798 808 364 405 821 961 253 197 494 225 321 258
87 499 858 970 991 95 149 285 8 753 895 594 839 401 539 12 442 117 939 536
