20
78 257 179 140 711 997 839 471 415 827 928 409 117 933 41 329 257 747 45 102
181 521 680 721 545 477 423 575 696 981 874 177 222 829 782 98 987 244 677 764
414 119 943 403 569 430 812 723 164 733 770 256 813 629 819 933 621 941 24 701
737 986 603 706 34 273 568 32 970 77 428 509 430 241 806 1 937 756 872 993
728 751 297 66 9 681 754 393 519 951 8 869 108 289 566 101 541 378 152 516
62 665 229 835 275 602 236 845 423 187 408 646 10 850 776 76 617 348 223 452
802 791 240 559 145 202 443 259 415 581 552 82 455 563 479 883 860 377 559 262
464 783 668 552 665 287 992 122 900 463 670 492 784 434 781 812 276 340 755 560
621 71 741 700 161 466 430 573 506 362 780 825 829 310 730 823 343 831 446 670
614 353 901 777 102 206 43 714 614 628 456 239 135 795 820 153 554 399 686 77
122 461 118 538 153 333 879 728 922 945 60 183 665 867 730 187 282 578 120 261
641 605 577 823 295 58 722 969 253 308 592 243 122 322 303 240 291 831 248 131
129 23 187 806 117 991 163 35 849 694 430 385 837 896 194 842 521 902 804 502
390 404 286 599 263 108 730 647 818 334 106 724 447 798 715 316 680 518 267 214
523 852 632 349 19 559 645 348 378 551 237 977 544 237 563 810 455 543 157 959
133 826 829 65 406 521 348 599 290 602 893 567 124 396 343 337 327 699 434 66
370 505 501 424 94 198 716 970 592 471 486 674 99 112 887 515 452 816 98 766
741 225 781 623 434 495 457 293 898 445 571 866 937 499 726 405 97 742 446 156
258 332 380 437 514 144 101 330 842 152 772 950 218 963 954 792 652 44 599 889
415 379 761 855 924 617 997 95 503 53 362 524 854 410 666 960 809 792 941 944
