20
3 320 11 313 871 466 450 56 861 196 24 77 874 125 414 217 514 739 799 659
770 428 65 374 409 225 819 70 547 52 594 743 216 680 12 264 463 652 981 279
454 858 949 741 310 302 216 338 583 226 559 10 461 366 428 985 37 588 949 663
805 861 327 799 854 385 929 811 144 814 909 767 167 233 22 927 275 391 211 312
105 898 410 212 230 805 180 523 680 465 500 547 380 212 587 198 206 565 654 501
214 642 26 28 116 795 182 622 201 162 136 744 354 643 629 768 227 110 491 852
168 922 991 886 678 433 695 620 601 988 6 672 669 474 201 705 88 847 404 222
124 390 478 55 469 366 858 131 460 535 196 546 27 900 795 640 778 499 772 264
866 376 804 605 472 325 816 61 769 200 932 862 951 423 635 882 71 266 827 749
398 444 383 63 364 438 584 9 611 53 137 721 475 561 608 708 243 72 667 366
265 752 201 169 507 207 257 817 700 645 278 234 676 204 159 612 793 871 875 245
562 43 271 578 973 110 847 151 980 864 283 611 955 985 931 698 368 413 847 637
107 551 226 564 129 108 821 948 586 470 942 764 205 299 156 673 90 227 750 786
372 333 447 942 662 221 546 273 503 397 110 748 34 869 633 195 722 89 389 440
803 937 607 55 567 348 812 975 760 228 632 526 321 134 960 906 834 196 210 843
418 593 744 237 1000 71 459 794 294 564 168 244 841 334 714 789 635 72 341 111
198 364 992 994 133 401 629 947 266 772 827 548 876 858 855 797 270 516 570 73
347 959 802 866 523 287 233 999 226 685 137 5 480 485 158 589 455 577 79 30
521 404 781 827 5 827 770 156 759 186 986 755 168 65 672 398 943 402 994 397
845 354 259 535 181 914 316 827 381 687 429 323 152 799 220 566 989 245 387 76
