20
968 235 616 191 259 730 26 605 417 623 96 536 921 611 931 219 728 680 409 305
151 102 143 118 309 187 209 626 664 205 310 892 940 889 397 450 618 376 382 767
34 833 335 996 343 38 361 850 235 943 602 397 168 778 853 153 440 553 437 263
388 467 516 564 672 577 508 411 240 280 966 675 284 127 894 550 366 180 43 223
559 633 542 635 364 10 929 956 641 477 959 629 341 100 283 121 758 138 343 578
484 625 742 774 404 572 899 58 677 73 709 463 699 984 547 29 67 937 10 720
948 999 717 519 48 357 592 920 757 903 705 1000 662 630 676 305 609 65 696 8
507 682 614 199 673 668 829 817 501 952 187 956 839 455 61 942 59 424 132 925
43 58 923 429 878 238 672 60 127 174 166 124 724 229 68 575 54 112 333 948
489 818 146 168 767 622 734 537 987 199 755 730 186 39 904 846 802 204 429 592
574 646 935 881 796 929 497 646 187 653 909 865 478 226 159 696 430 50 10 813
136 869 2 111 819 280 287 964 310 171 943 112 654 569 998 785 912 988 378 298
882 265 241 384 775 395 110 613 877 423 50 839 646 596 563 130 777 642 162 952
995 66 861 644 535 314 121 468 334 908 892 140 17 607 882 318 8 502 766 128
429 420 776 733 735 286 458 805 343 580 377 257 592 753 468 375 976 900 147 703
581 540 862 688 455 572 971 538 185 185 715 628 162 822 912 690 728 694 898 395
182 813 558 672 997 131 161 476 962 766 782 453 946 749 923 942 590 634 546 706
831 211 288 818 251 334 592 223 450 91 363 607 886 538 997 410 269 731 705 594
525 213 553 134 429 193 410 590 915 121 325 502 838 718 301 820 31 293 782 578
352 554 652 219 603 161 53 391 708 863 482 68 616 714 537 758 779 963 106 139
