20
984 856 315 131 896 438 258 957 534 217 984 29 861 93 536 683 32 483 858 743
235 132 748 687 313 219 116 655 876 684 116 285 2 763 470 87 103 491 940 573
54 196 834 314 482 70 603 497 760 584 147 155 200 717 163 816 811 358 117 656
157 882 296 212 263 872 318 888 505 847 29 910 271 921 554 524 291 770 774 947
345 811 138 257 292 682 804 301 204 838 223 120 505 193 953 76 964 549 60 40
717 144 482 58 682 549 868 726 903 723 880 293 125 66 443 614 578 630 389 826
424 154 447 751 578 518 833 259 384 441 350 581 418 355 25 850 264 510 12 294
596 928 123 293 653 159 94 793 919 870 447 706 322 638 849 630 485 918 346 980
176 143 263 507 579 675 901 187 413 562 722 618 206 170 490 689 556 469 872 726
861 665 799 569 959 662 570 749 241 574 936 787 680 467 666 705 460 571 347 396
531 407 165 252 231 986 25 943 518 753 231 946 833 107 79 506 979 986 654 263
1 328 752 242 592 297 175 160 419 551 709 210 600 89 625 198 587 773 167 279
714 122 783 113 258 917 395 110 35 794 612 540 648 561 734 530 549 307 865 328
635 116 247 701 775 677 74 144 293 572 716 148 903 220 923 242 777 716 100 896
614 149 430 925 799 314 932 432 223 374 53 980 168 496 593 279 747 607 528 959
710 656 689 968 283 358 968 846 262 637 439 434 538 333 801 109 213 666 789 273
938 895 497 127 168 179 520 408 962 672 556 86 649 562 440 244 500 66 308 844
761 17 259 186 357 664 393 504 67 998 682 603 761 56 936 414 115 169 115 58
702 839 937 883 796 487 390 658 513 979 247 250 241 314 128 321 619 601 296 997
69 228 213 119 824 962 907 496 636 963 458 916 348 218 818 8 954 723 962 370
