20
210 335 911 19 848 664 243 438 203 45 359 604 928 300 291 286 134 270 717 191
507 667 502 94 696 805 874 26 223 282 616 653 706 428 298 414 639 648 370 902
836 700 357 35 806 937 952 350 43 216 184 254 241 37 156 476 902 266 676 376
521 504 742 135 652 617 559 76 404 593 242 859 678 269 761 864 170 445 964 987
146 432 171 701 12 595 371 966 461 755 265 670 731 846 793 88 401 525 10 78
849 282 441 17 938 762 151 926 450 724 793 176 35 300 691 80 678 245 880 500
881 598 17 956 590 733 185 302 811 302 856 284 871 727 781 593 163 101 554 807
761 295 937 999 338 54 974 473 395 807 512 137 850 540 667 179 516 255 689 931
86 388 874 15 254 606 447 927 689 722 238 473 493 405 374 983 114 398 992 324
414 92 502 771 797 888 183 916 396 727 404 786 118 911 503 312 360 482 91 275
549 934 368 503 827 142 808 819 575 260 423 878 938 26 959 651 60 775 684 848
820 692 368 276 865 327 616 493 966 546 948 10 510 899 984 628 430 543 620 284
601 396 204 893 804 257 258 711 600 431 676 514 160 951 204 393 220 531 473 273
938 385 542 965 924 217 502 642 691 835 198 748 381 992 934 470 537 781 358 373
842 465 850 711 182 741 772 466 925 155 3 662 639 58 821 214 330 975 108 156
998 631 197 672 466 766 705 183 212 460 121 820 268 702 590 38 463 631 177 768
639 219 876 108 788 64 274 265 86 966 569 461 307 834 225 759 733 132 672 586
74 339 375 1 232 528 538 938 785 812 825 40 858 155 838 571 326 28 175 223
939 970 59 617 396 458 995 313 467 235 155 275 816 266 472 797 463 506 462 106
610 189 804 249 199 469 951 739 250 919 789 3 228 600 889 745 222 276 414 921
