20
853 142 329 855 429 553 494 964 245 798 268 351 290 529 794 960 952 323 911 529
744 676 990 725 234 823 646 675 841 727 314 515 364 243 251 941 391 665 921 238
371 276 345 910 359 25 622 605 118 528 4 124 881 108 8 169 914 175 412 307
920 233 391 675 242 580 523 121 416 964 723 270 457 471 148 4 640 15 713 80
430 342 767 386 60 181 866 154 367 50 495 118 162 373 216 219 972 98 834 718
107 821 244 635 266 527 318 507 286 617 209 84 446 22 666 392 777 649 910 78
222 343 154 957 406 337 593 175 354 571 783 509 514 492 256 853 57 419 54 434
881 478 45 285 798 295 901 414 703 271 935 644 949 537 247 275 1 507 18 126
314 233 345 492 440 431 560 791 474 884 360 678 629 586 606 973 133 706 956 545
163 898 478 934 898 479 355 601 471 682 172 760 119 613 332 582 621 298 794 684
226 649 125 476 890 739 715 972 173 892 990 533 756 372 958 629 293 573 15 909
714 497 755 48 868 115 434 701 518 32 312 430 606 25 101 671 670 363 674 151
885 797 730 989 414 932 219 248 983 911 440 246 350 454 750 76 990 618 783 119
497 779 53 367 433 408 689 813 497 118 892 122 812 227 544 228 434 137 559 272
582 957 562 460 119 513 109 397 52 516 970 371 774 851 23 698 43 309 381 939
797 658 264 116 587 295 272 383 332 343 846 748 660 633 233 471 929 364 475 548
509 843 203 260 349 504 916 366 972 560 35 171 565 436 658 153 481 291 252 426
318 125 928 541 155 222 314 599 264 94 46 353 766 339 733 726 544 457 439 715
730 167 766 711 361 859 94 51 29 769 843 280 972 626 809 426 6 467 235 927
458 614 782 445 89 908 641 345 945 99 679 516 457 891 231 587 128 958 640 459
