20
438 754 840 732 723 579 214 662 296 939 374 119 708 768 332 12 317 969 240 679
852 784 375 40 676 184 740 717 331 39 193 710 578 642 998 322 291 168 217 836
10 720 664 961 936 84 986 495 286 540 900 897 674 781 908 433 252 289 817 802
242 61 172 514 892 758 300 868 662 422 420 428 150 715 449 558 818 783 31 978
112 642 635 384 645 846 946 13 599 417 311 708 690 737 940 563 397 874 94 941
347 113 197 854 555 825 766 314 759 414 630 372 90 294 764 766 499 561 802 366
877 8 44 364 48 14 221 714 673 749 862 843 65 3 231 992 154 692 860 880
539 645 990 303 879 738 907 945 46 113 727 610 635 549 804 470 398 746 556 567
833 922 226 489 494 345 895 988 318 540 260 69 462 973 539 754 623 604 62 348
494 33 372 222 185 979 257 685 437 728 367 160 55 289 155 687 996 962 572 621
175 936 767 768 815 737 6 324 974 574 637 785 85 979 591 179 228 517 206 918
606 674 280 480 676 906 15 430 62 807 100 442 664 742 730 378 273 733 479 333
886 813 81 424 953 657 943 429 272 370 725 645 6 861 568 706 194 604 518 552
893 92 323 286 365 354 218 514 75 656 374 360 6 908 953 124 523 369 82 110
406 979 506 612 504 447 775 693 105 747 503 551 476 928 368 966 810 729 121 11
214 78 879 444 102 605 519 442 859 130 401 200 197 874 469 438 893 318 847 216
433 452 132 82 708 402 877 600 244 679 571 623 239 135 428 869 402 993 76 601
978 915 519 430 207 736 325 265 837 920 424 217 244 180 222 350 636 324 200 108
88 904 138 841 153 177 146 131 263 924 739 599 835 422 583 231 728 299 974 605
155 56 816 92 262 331 488 117 487 785 135 393 123 150 70 752 2 733 525 869
