20
750 515 290 732 70 64 579 405 869 761 488 523 215 285 883 178 601 362 888 47
105 426 559 265 284 989 164 946 43 628 719 353 312 46 117 870 153 852 77 525
909 286 728 421 67 669 954 808 192 282 770 400 956 550 118 920 76 174 55 268
588 496 311 641 480 364 559 736 42 868 146 399 536 59 935 487 191 662 973 983
589 186 740 774 393 124 23 755 678 405 83 29 947 759 810 489 775 153 584 162
554 598 588 217 56 890 130 635 559 490 996 927 341 368 613 352 66 990 588 451
676 496 838 219 293 327 113 103 217 455 60 220 200 771 471 605 757 712 442 431
853 798 218 350 723 396 394 757 711 398 866 74 123 136 20 977 523 492 260 266
994 971 613 950 546 227 354 250 937 251 331 351 469 205 65 443 664 781 918 780
776 317 622 38 779 95 693 47 509 520 125 688 18 483 430 924 774 63 518 112
467 414 472 972 121 401 986 521 360 789 28 165 740 688 933 858 731 429 159 277
26 535 8 512 837 318 439 891 927 544 723 219 540 489 280 511 911 872 398 281
860 636 489 101 939 275 858 26 832 877 546 987 998 237 807 532 700 299 884 598
524 471 484 61 692 146 627 207 96 571 464 143 926 741 398 715 290 833 58 396
419 270 49 332 111 814 389 884 608 683 888 202 455 227 494 970 140 718 243 330
880 894 846 203 333 350 512 110 626 298 85 950 58 129 332 990 375 64 584 601
478 167 294 643 103 558 305 682 990 700 188 333 80 496 355 887 438 266 944 331
16 870 986 255 335 143 488 418 152 520 285 623 584 995 739 128 828 865 432 503
977 745 495 895 889 565 290 119 927 44 790 945 428 38 747 832 182 850 513 525
942 463 193 218 373 41 331 416 288 708 545 600 243 872 980 890 732 667 274 918
