20
512 266 212 976 748 21 378 214 449 590 212 513 47 30 52 172 878 590 881 400
681 123 706 114 576 898 814 468 282 187 518 598 357 699 776 334 933 531 624 85
924 231 257 610 587 879 332 734 105 206 743 413 306 802 663 742 803 241 437 934
198 789 298 490 456 209 714 234 582 664 843 851 627 545 321 918 352 576 611 455
768 305 813 492 632 812 809 948 74 265 532 636 505 299 111 755 34 606 743 875
997 162 984 407 517 709 4 703 912 419 381 369 120 666 566 535 176 536 927 555
944 977 193 329 54 99 549 60 668 656 352 554 815 356 904 244 953 120 923 787
308 290 129 714 849 224 33 483 16 767 860 133 573 531 743 21 11 394 675 438
28 701 339 455 415 443 514 532 15 218 328 349 433 159 807 79 829 791 542 613
254 786 298 262 421 863 523 533 70 511 318 181 468 849 117 376 16 556 402 316
14 579 4 134 402 914 908 943 872 503 673 701 802 819 867 266 483 653 63 395
801 582 311 481 888 494 400 21 698 384 464 344 584 195 619 1 583 826 321 2
15 999 670 25 669 297 390 523 506 906 138 317 638 570 161 865 839 634 726 970
73 571 798 339 195 258 854 921 994 631 457 811 315 927 789 241 303 269 107 881
593 74 97 612 699 283 329 921 242 329 820 14 946 625 72 530 286 379 575 327
650 548 268 361 458 664 970 110 245 991 510 52 41 867 447 1 502 544 747 752
76 361 633 656 813 557 223 12 108 375 62 683 367 423 954 733 679 488 593 260
535 380 292 666 752 826 304 632 956 221 858 881 794 326 85 33 995 771 361 946
528 344 432 779 57 148 880 63 282 771 686 847 871 988 599 176 295 100 81 901
326 958 209 842 713 846 12 118 697 219 74 1 491 67 115 654 544 865 629 482
