20
290 96 232 579 445 833 209 134 424 737 708 60 647 397 661 268 206 709 106 529
862 947 301 683 957 288 617 370 814 371 358 933 268 184 793 160 280 289 802 133
786 912 836 270 947 961 346 128 749 155 75 535 384 940 959 143 668 782 321 587
621 733 550 671 478 205 974 382 682 724 295 391 25 497 185 396 227 632 487 956
335 654 680 902 252 469 425 511 301 151 110 832 198 579 174 110 491 479 119 478
940 559 779 536 195 974 901 322 201 409 612 546 637 287 496 424 57 750 106 522
543 79 552 378 592 631 642 853 359 722 184 847 101 493 56 710 36 144 712 748
479 882 525 7 421 131 936 664 854 613 770 351 150 663 484 328 346 156 995 99
792 510 865 270 583 143 749 186 936 952 18 806 364 443 533 958 481 675 791 792
359 420 414 92 259 365 885 422 830 674 163 71 384 723 451 149 571 312 802 68
404 878 509 195 92 952 516 418 397 943 888 725 479 689 174 352 551 642 46 583
912 831 219 412 104 212 228 36 975 440 682 173 958 804 496 39 190 214 584 945
585 962 116 577 282 614 77 511 351 577 143 367 326 782 160 218 343 747 724 180
651 947 94 468 359 523 754 99 675 61 968 122 258 667 280 240 949 313 268 260
903 945 856 780 58 413 382 182 423 996 967 549 376 938 409 277 545 641 493 279
220 993 255 945 40 84 325 30 672 825 687 745 900 794 591 878 85 120 668 78
201 793 755 905 851 933 865 987 981 574 374 49 604 292 181 67 25 579 65 629
692 237 13 551 463 700 311 790 298 730 243 981 409 597 2 656 310 332 406 135
660 227 571 879 959 677 365 77 980 334 762 113 510 198 578 239 631 707 857 536
15 520 343 602 260 253 458 62 991 885 349 759 506 712 14 809 938 370 975 123
