20
234 37 261 551 322 345 909 689 284 879 169 974 774 450 72 966 437 591 368 532
823 66 465 515 960 477 504 896 31 23 727 739 748 949 731 242 510 105 532 335
262 339 130 565 812 2 545 659 589 560 567 257 912 217 261 675 662 11 888 244
69 564 815 653 277 960 709 257 335 331 593 869 84 593 70 661 777 632 182 777
759 474 885 29 179 930 378 472 698 689 524 103 643 487 522 761 930 322 954 426
579 972 297 902 381 957 753 448 558 508 134 539 107 487 265 241 716 369 405 134
563 115 649 645 245 807 715 567 976 368 542 777 253 797 775 663 865 229 668 981
621 9 820 842 34 375 282 65 649 227 855 774 189 561 691 724 551 10 61 289
14 560 158 713 10 683 881 122 279 391 26 960 930 358 954 794 631 107 723 663
856 402 729 207 427 400 508 273 191 853 827 645 99 405 344 608 560 276 121 112
483 398 241 130 834 862 797 217 322 433 432 844 603 263 857 628 934 657 775 883
283 402 775 80 216 687 632 705 708 357 524 611 278 125 805 374 713 752 625 441
190 38 149 265 448 901 934 169 318 891 27 844 463 543 163 989 887 620 482 947
77 159 21 505 805 376 732 601 421 312 677 624 939 864 880 110 395 355 681 91
525 828 806 510 718 322 531 127 168 668 286 156 754 687 736 337 669 918 994 241
519 386 864 76 793 547 53 890 239 859 135 304 996 896 473 995 585 298 247 798
566 222 767 808 348 471 191 261 74 330 798 648 178 245 684 107 590 933 564 565
546 609 789 982 48 807 699 202 47 383 941 566 210 425 588 227 45 911 823 746
833 841 927 274 356 428 800 557 205 272 487 584 344 899 207 143 255 447 577 153
822 617 529 579 18 825 673 939 76 632 787 912 491 602 90 184 985 818 387 894
