20
918 447 338 417 260 554 225 937 927 815 854 190 150 707 457 519 778 788 107 188
434 468 970 971 28 749 206 665 341 553 66 847 600 881 433 944 206 224 230 954
60 539 625 675 669 168 482 560 465 688 35 483 802 222 963 232 928 420 978 254
254 114 456 519 21 632 925 911 958 56 221 957 645 24 722 547 174 147 261 355
157 428 214 915 855 458 610 668 655 862 390 837 916 477 760 483 45 306 658 263
132 934 830 983 938 374 509 930 814 422 199 891 515 565 354 984 341 405 558 564
988 922 692 817 446 632 865 730 389 303 375 956 164 498 405 551 522 642 30 833
8 838 176 509 828 574 839 131 140 318 68 874 119 656 863 85 660 158 810 247
128 628 525 888 701 354 885 929 192 810 160 606 153 596 992 514 477 973 599 193
856 827 562 686 978 560 354 495 99 643 947 124 687 999 662 904 203 154 857 808
145 556 504 577 134 595 815 412 102 36 613 506 391 379 127 360 703 155 308 876
305 429 287 293 554 660 695 506 423 285 672 260 515 955 305 490 561 35 766 18
282 470 630 888 612 712 384 789 157 202 962 369 164 395 54 511 655 695 717 441
377 78 888 976 222 649 840 887 860 370 837 993 444 171 342 740 545 11 515 600
293 236 23 530 903 854 343 634 409 196 942 393 795 423 433 736 463 804 551 924
416 682 837 235 943 649 405 713 636 13 37 567 124 391 862 306 617 100 988 924
707 348 164 943 563 711 397 533 86 117 622 594 954 46 561 252 643 929 560 782
243 95 477 645 711 844 106 634 421 260 466 514 797 58 121 471 118 764 291 570
522 109 772 86 362 583 429 580 327 290 46 854 313 549 406 363 354 403 844 293
733 432 835 563 940 556 312 396 420 736 903 903 635 137 74 162 383 798 583 59
