20
401 7 6 829 358 416 749 84 723 174 649 965 422 339 588 254 446 214 161 959
679 796 284 94 5 157 830 296 773 24 244 73 589 360 605 923 880 227 221 118
539 496 600 23 21 935 525 502 38 350 890 947 430 63 300 167 113 73 527 108
860 190 24 533 883 418 769 514 722 72 84 59 865 696 915 348 109 935 936 898
621 472 927 460 236 664 455 635 219 762 850 890 933 715 12 557 758 908 187 904
15 607 860 736 640 91 724 357 103 665 932 863 668 511 87 784 932 393 580 310
614 294 536 359 361 465 547 305 630 856 308 320 52 621 216 656 208 203 771 494
932 709 179 385 337 682 615 801 319 915 96 761 738 921 306 261 814 543 25 851
933 133 739 569 480 113 536 169 971 617 535 82 772 67 877 423 897 355 66 35
731 714 489 892 610 790 391 759 559 496 274 542 176 299 595 801 18 663 54 729
259 675 509 974 114 393 368 182 133 991 208 916 527 380 742 151 661 638 715 400
997 819 861 955 188 457 211 13 712 416 769 986 496 999 725 670 932 343 366 934
197 947 839 614 951 890 477 453 660 170 222 621 100 990 639 585 417 725 207 416
206 68 545 101 779 401 808 607 112 383 505 460 492 591 138 903 860 702 286 508
873 701 502 142 821 128 571 532 647 767 23 812 330 991 416 740 165 983 749 343
895 15 428 453 583 629 946 170 135 99 924 843 279 743 98 339 565 578 680 819
20 123 766 643 184 325 136 20 13 337 44 446 765 577 981 819 186 288 243 781
238 903 92 98 884 793 268 717 485 996 851 657 850 635 732 573 733 303 530 355
832 248 627 34 590 896 1000 212 355 961 374 695 830 10 428 988 400 692 572 522
409 198 905 305 361 879 60 827 222 760 513 616 532 860 275 652 981 693 207 99
