20
59 956 114 604 417 447 283 890 957 189 826 577 449 169 986 364 889 446 503 282
172 317 899 147 129 521 28 169 377 586 555 428 241 975 563 908 978 883 100 210
750 494 129 535 721 931 551 398 263 493 769 806 669 893 424 682 349 455 35 813
419 341 410 66 729 390 405 605 914 90 418 428 559 938 668 362 721 62 304 582
995 491 831 535 296 464 541 957 355 338 220 34 343 743 595 66 965 90 108 283
798 997 420 361 41 639 456 22 400 890 20 154 472 478 314 190 367 738 170 684
392 836 545 282 60 7 335 644 513 613 567 116 25 981 267 186 896 3 410 678
363 954 865 724 361 53 506 704 384 821 861 504 302 43 44 366 865 934 307 829
633 475 449 313 526 717 472 383 990 478 652 355 301 958 981 486 617 32 462 239
718 414 110 463 756 553 645 204 801 886 612 615 678 48 288 469 712 925 212 367
881 194 522 209 314 710 119 144 855 2 710 53 879 655 4 22 268 524 575 443
285 408 283 810 33 389 867 18 90 706 878 136 178 938 32 916 956 593 117 469
755 899 301 134 277 415 924 937 894 652 675 972 450 160 276 945 253 311 269 111
624 299 29 936 84 51 985 474 98 504 89 534 533 722 342 667 926 186 381 526
27 854 593 525 860 251 480 802 495 44 527 187 991 852 151 609 258 313 558 540
19 589 785 657 158 75 605 732 157 595 483 121 430 21 613 942 231 325 686 907
531 261 504 730 742 310 726 708 707 984 182 161 664 191 168 406 50 274 44 385
629 964 411 150 430 14 205 232 769 843 690 856 964 134 67 940 517 628 738 732
205 161 107 782 600 618 408 750 744 740 810 390 340 345 978 847 683 999 717 98
449 297 93 577 358 391 132 347 415 615 516 416 630 628 36 577 462 120 949 237
