20
23 478 619 506 257 843 946 244 638 173 597 513 734 37 291 640 992 886 819 164
897 989 822 169 924 153 874 651 206 440 909 847 29 758 662 30 10 922 253 852
140 283 927 886 522 454 382 58 543 579 196 949 920 378 407 361 80 795 506 226
793 655 123 740 856 416 696 470 384 427 367 259 289 297 880 954 893 594 654 138
455 486 896 691 275 147 152 823 552 955 733 459 956 572 745 411 410 829 602 131
333 670 481 927 59 341 459 361 36 435 765 865 719 123 970 675 770 905 96 359
352 647 623 160 784 567 181 398 307 725 271 76 506 856 610 919 167 670 717 158
511 538 979 645 474 104 20 764 249 306 987 494 734 433 686 500 503 809 273 628
296 457 353 759 171 824 129 506 948 298 176 128 265 483 734 811 881 34 280 824
702 159 462 764 220 225 647 432 44 207 458 630 872 870 469 252 286 201 536 798
301 504 91 256 152 436 37 421 145 650 83 552 516 691 282 760 688 677 37 524
628 152 995 347 337 281 449 268 25 161 27 226 781 75 610 731 914 29 352 721
194 135 634 207 83 734 196 832 471 304 843 935 656 724 88 301 899 73 583 16
198 163 46 45 38 421 358 205 931 725 502 331 220 310 370 588 867 35 119 454
219 362 225 871 678 390 429 133 924 801 548 41 698 741 739 522 332 624 133 133
357 294 88 765 113 177 49 821 356 468 272 219 738 807 391 651 217 197 399 755
398 871 824 207 389 217 578 123 117 826 107 981 51 479 969 17 1000 375 56 90
558 924 292 552 197 97 944 852 506 550 198 299 678 793 641 608 150 217 259 496
171 201 690 33 385 266 37 479 207 108 357 337 609 121 710 649 930 652 549 973
123 115 274 842 76 904 440 358 343 997 965 630 899 197 766 381 931 134 25 764
