20
523 314 666 254 765 256 764 317 460 113 630 825 640 450 989 259 609 703 897 477
340 92 85 727 898 685 646 588 147 78 693 845 212 316 415 958 966 838 888 79
512 341 993 721 849 634 313 705 617 321 925 761 905 366 512 912 419 36 436 631
160 987 837 592 226 161 541 114 571 871 754 199 265 917 540 889 196 655 627 125
636 6 746 69 385 451 513 268 573 89 148 721 995 762 933 916 273 243 743 113
663 177 669 865 364 840 160 140 155 341 567 49 679 658 349 751 184 87 378 989
262 105 207 197 115 927 838 887 40 725 906 128 836 671 26 127 759 945 469 406
846 262 654 886 426 712 678 237 960 63 882 263 2 587 897 197 18 103 855 346
139 437 726 938 770 384 299 741 215 486 40 331 483 920 16 468 407 544 821 812
297 829 721 346 557 867 847 480 325 641 695 133 219 224 121 228 895 842 472 231
799 318 131 667 555 495 599 643 526 317 742 15 237 976 867 880 842 468 674 682
219 713 673 157 650 526 72 386 613 722 613 499 613 51 385 984 778 21 754 195
23 267 438 963 249 293 932 238 922 935 735 204 494 666 70 656 587 145 258 788
283 622 692 551 125 191 48 653 587 485 935 139 85 413 610 532 823 755 279 72
416 400 838 998 513 432 109 950 675 25 998 146 838 369 142 708 50 768 464 913
213 630 218 90 883 828 780 845 766 453 477 962 817 63 394 125 679 249 708 473
81 292 84 403 530 982 425 930 730 404 1 749 946 872 567 264 826 156 635 898
847 678 607 247 256 339 579 428 478 775 500 245 643 472 60 73 934 852 173 972
78 922 86 499 629 736 467 830 837 503 167 995 270 810 646 565 303 421 385 581
228 178 596 943 385 883 151 208 936 80 438 99 9 189 725 625 24 609 845 275
