20
211 548 714 583 562 51 994 984 871 46 624 385 580 554 462 526 373 9 822 198
360 360 32 334 323 323 660 922 405 863 518 582 271 559 975 879 319 849 721 739
462 641 178 93 890 269 609 129 179 964 80 67 667 276 665 143 93 625 966 844
733 244 72 623 536 69 645 35 471 239 595 683 586 427 197 616 239 480 343 463
151 391 808 489 317 15 164 40 988 418 260 445 651 884 813 438 340 397 898 206
481 705 748 990 446 702 631 332 286 203 458 777 274 203 5 68 139 428 588 355
40 705 901 189 432 350 317 557 987 573 601 682 391 79 742 634 622 736 320 504
4 330 436 5 411 831 315 413 997 98 298 736 517 742 24 514 184 197 809 990
168 737 755 143 498 812 313 896 41 491 321 720 148 195 937 34 709 526 146 339
429 957 664 939 914 628 187 229 863 924 970 464 692 450 853 69 799 246 152 965
361 563 225 421 397 648 729 750 55 578 98 633 119 178 636 435 509 650 798 459
44 603 212 189 656 314 244 295 40 367 620 679 950 629 806 355 581 226 169 26
54 191 687 835 732 770 811 164 178 818 6 715 160 227 963 972 974 828 538 916
125 81 838 728 907 731 168 688 653 718 136 900 104 509 323 833 772 845 522 640
624 260 567 119 694 842 279 42 820 877 707 245 326 617 996 470 872 460 423 103
192 263 739 784 250 791 392 466 11 959 416 319 444 368 39 459 701 99 257 279
551 714 141 401 560 41 874 997 812 309 916 799 728 169 43 499 264 986 143 21
539 29 310 497 208 347 386 311 642 502 781 810 646 511 900 384 897 95 175 999
547 930 832 42 556 331 291 927 952 386 648 694 719 778 107 574 41 974 350 853
950 969 365 970 72 890 539 276 377 829 84 612 662 123 733 955 637 935 533 309
