20
210 385 753 982 206 776 867 682 225 167 211 96 479 181 534 108 263 849 458 343
951 794 490 517 304 318 166 805 122 94 166 945 148 4 385 773 358 130 852 337
812 33 353 478 802 439 488 762 96 786 36 205 322 233 552 407 964 503 643 423
78 896 687 528 939 63 886 985 599 112 289 996 506 329 394 299 20 584 279 864
132 855 753 614 29 769 109 280 158 513 632 651 6 31 268 960 12 791 843 391
599 187 879 955 538 240 746 629 606 901 12 144 232 975 201 844 216 249 871 236
10 474 884 806 546 324 525 770 913 816 44 627 819 281 217 780 366 657 681 770
973 775 317 529 42 304 716 797 990 303 907 568 885 305 836 575 529 440 864 313
138 332 750 273 859 660 819 981 717 405 772 872 808 539 315 818 239 986 203 222
304 696 726 116 816 107 170 788 450 550 231 598 267 207 895 918 85 905 912 608
151 173 955 928 916 816 643 701 328 333 907 977 166 304 251 790 170 89 593 981
789 673 353 40 433 444 189 512 981 356 938 883 544 416 704 436 129 367 135 198
441 432 113 992 308 929 440 701 769 381 648 835 660 5 665 600 344 697 784 189
11 424 764 641 520 715 482 265 385 406 88 337 512 166 67 290 763 618 557 5
345 290 58 462 684 793 488 468 664 553 795 973 398 471 507 643 687 689 909 449
897 219 830 291 576 796 995 349 898 835 738 568 598 988 811 441 511 973 401 975
980 395 216 491 726 81 27 341 365 651 776 246 821 862 482 470 522 685 207 556
694 141 724 647 318 278 18 565 459 534 730 843 18 531 842 721 744 619 809 839
51 71 928 272 862 455 217 628 358 841 314 382 608 140 958 132 980 68 898 508
205 395 949 157 170 837 610 318 638 399 664 66 675 373 696 576 426 706 91 371
