20
567 121 767 868 693 54 895 387 531 339 91 577 34 293 632 418 979 458 528 835
702 755 481 992 352 821 851 495 220 903 891 144 465 812 265 625 377 753 148 416
165 64 281 2 742 663 759 898 810 165 562 890 775 272 765 323 17 183 581 246
537 68 905 561 897 251 424 667 244 137 559 100 264 638 311 274 133 101 822 36
490 525 778 655 76 710 821 480 222 177 989 60 962 656 244 723 636 595 62 44
401 726 101 287 501 582 203 260 414 869 303 579 757 702 103 365 687 964 165 307
685 191 743 589 458 302 516 366 413 496 648 131 903 782 196 353 602 322 869 538
650 89 982 963 288 645 28 602 343 739 92 423 945 350 397 249 492 27 482 324
293 638 530 701 634 853 804 482 549 828 569 660 295 83 91 712 412 912 477 520
598 322 337 330 375 565 571 79 329 703 229 55 544 744 218 981 318 53 751 268
69 582 599 987 410 363 832 467 799 910 889 526 706 964 719 984 468 336 690 781
797 347 998 834 233 986 162 979 714 234 194 386 307 940 500 913 984 483 400 983
176 968 87 891 89 494 170 168 543 21 109 215 695 562 754 531 142 237 286 465
109 171 139 785 421 420 438 334 835 34 102 986 64 353 255 256 633 688 293 225
972 317 881 703 576 439 610 687 889 383 170 323 163 1 305 564 154 671 332 727
936 991 942 863 438 747 668 398 337 755 528 362 151 205 15 867 889 405 876 19
474 162 847 684 914 314 348 181 944 379 175 913 87 661 322 355 185 307 348 989
805 964 813 807 18 753 654 522 945 550 982 765 657 223 713 929 310 576 22 877
18 384 979 233 912 701 154 602 622 435 250 118 936 583 981 385 503 636 95 976
655 816 741 293 404 324 301 56 944 441 837 111 901 474 180 158 38 150 479 539
