20
701 758 251 599 77 953 10 354 791 679 186 564 705 865 316 818 355 300 441 154
775 870 831 361 99 443 344 635 478 373 566 508 957 262 106 732 457 860 1000 359
339 475 7 89 917 388 624 816 987 293 459 839 594 750 163 27 997 737 341 961
457 640 369 468 395 484 171 724 831 35 804 94 531 922 343 148 584 788 322 977
213 18 458 554 311 25 765 431 940 120 992 556 525 261 374 684 82 781 664 850
528 220 708 250 205 17 916 941 319 374 834 537 785 360 677 374 266 298 805 527
52 561 380 473 999 437 896 186 686 941 857 293 555 366 255 419 762 563 56 968
172 553 352 673 528 951 906 855 410 982 612 922 891 418 20 511 385 830 284 862
955 511 983 401 773 510 784 543 317 303 52 531 705 834 37 993 295 918 120 586
220 594 828 97 83 807 418 481 682 599 728 413 737 902 185 3 746 877 333 814
457 469 848 797 470 814 551 797 300 339 273 439 876 988 832 157 27 664 352 708
99 269 262 707 741 860 811 510 447 537 490 283 799 275 605 906 952 122 128 309
712 550 160 184 259 640 840 915 67 318 807 907 564 893 771 164 914 33 730 280
640 310 494 798 881 134 811 990 278 981 495 60 631 945 736 834 502 962 635 423
550 540 244 452 481 69 968 313 454 439 178 700 26 67 165 159 254 150 203 32
302 858 842 390 718 615 332 992 554 466 721 408 29 985 88 339 283 550 283 391
511 145 997 686 392 356 977 407 393 6 791 88 866 927 768 26 121 931 213 15
116 565 425 402 609 371 764 106 176 251 197 813 993 714 968 157 599 535 508 532
792 809 854 684 847 307 233 84 115 248 363 943 647 790 56 319 91 623 733 263
523 875 630 922 368 708 326 643 44 255 201 840 468 151 209 696 839 820 786 42
