20
382 351 97 896 376 630 902 373 140 393 580 994 880 314 991 320 52 739 101 24
1 10 23 758 830 763 602 106 600 381 26 743 281 616 960 704 582 207 909 896
253 130 910 131 347 688 631 512 574 170 904 208 56 866 746 944 952 423 332 548
843 477 589 310 287 329 239 850 232 631 43 419 43 426 6 357 33 234 118 16
678 516 261 512 634 969 53 99 537 724 610 704 640 934 502 581 888 799 171 328
960 809 488 175 405 353 342 216 886 691 71 570 480 143 257 959 597 985 587 832
187 198 611 507 171 439 472 592 264 412 218 832 683 837 920 923 852 738 543 511
732 924 605 574 377 651 874 173 427 819 845 497 804 426 647 403 42 438 943 337
264 77 91 789 872 980 698 475 773 619 802 658 921 139 194 336 561 224 656 647
763 98 550 65 352 875 694 657 86 11 1 829 756 777 669 594 52 98 629 590
776 549 972 931 270 9 986 771 251 524 30 164 544 933 30 339 822 911 991 969
128 568 975 998 944 521 933 619 308 803 963 6 314 212 520 851 761 912 737 520
661 348 104 404 404 507 43 192 439 958 736 36 790 574 922 824 698 1 754 19
399 3 565 261 718 476 650 81 765 970 589 423 774 860 734 838 533 398 914 820
713 174 508 339 258 92 48 50 257 143 133 973 860 977 229 576 949 204 55 266
744 65 802 114 782 660 522 882 495 449 886 557 420 485 328 286 741 583 325 3
192 833 861 404 639 480 822 32 404 507 214 797 629 858 971 552 138 738 911 548
153 294 657 846 806 370 139 69 892 784 790 728 887 840 825 740 517 941 874 497
167 179 873 310 93 644 653 632 698 289 328 663 102 529 389 151 194 796 680 156
308 12 18 170 731 66 565 863 592 585 611 393 780 973 296 75 135 550 957 825
