20
614 171 778 923 285 850 481 678 208 442 766 368 159 744 462 287 435 748 968 606
97 423 388 618 924 199 202 406 869 673 612 260 440 251 871 891 915 129 501 63
280 637 57 760 32 356 89 128 372 837 792 661 63 272 998 985 293 377 682 288
445 844 180 813 645 6 621 919 708 19 844 764 78 241 618 685 380 806 585 177
73 562 433 473 300 321 597 881 609 103 725 493 283 334 925 169 554 104 760 390
496 344 503 835 810 835 386 775 575 910 606 520 886 190 167 387 471 731 803 134
840 654 38 443 236 608 982 569 930 677 102 543 279 955 337 404 41 836 157 968
627 294 409 899 286 485 743 994 304 634 40 430 733 968 989 854 229 181 602 872
904 165 635 876 439 509 38 579 86 414 435 33 331 777 292 911 795 217 763 12
327 595 986 580 367 288 733 830 774 621 846 54 362 306 416 11 233 582 708 225
627 995 81 114 904 274 655 230 777 412 938 372 398 495 617 162 548 994 1000 924
924 438 918 347 384 102 26 581 511 756 532 485 210 607 520 123 103 557 422 434
1000 947 412 234 377 214 883 720 105 881 32 894 960 149 104 984 101 9 504 770
710 290 765 310 513 490 356 371 635 736 593 957 379 104 582 109 435 378 632 787
475 159 316 182 835 533 544 212 624 229 950 539 135 809 224 238 613 767 753 308
728 190 935 278 604 235 166 526 500 221 231 649 825 432 240 911 317 546 202 547
328 505 109 759 737 864 925 823 863 915 235 810 965 456 695 338 504 503 387 117
699 589 412 752 358 975 368 855 424 396 118 404 703 419 351 825 641 765 950 303
877 712 605 361 864 1000 256 571 314 257 45 335 447 768 469 643 240 713 436 531
597 481 148 605 389 217 387 462 181 305 379 353 816 29 715 569 587 747 840 808
