20
105 6 122 430 431 870 563 504 548 347 246 425 848 987 672 810 422 146 188 817
486 1000 143 920 926 386 607 378 75 818 459 171 20 566 822 613 793 19 202 315
293 906 920 654 469 694 715 527 156 117 497 396 226 348 741 546 617 99 139 347
484 154 825 179 527 633 815 532 90 258 982 666 521 411 998 249 827 856 281 592
495 358 663 580 663 899 792 965 769 168 613 414 291 476 990 807 531 260 456 605
950 108 449 956 672 651 138 251 259 743 233 982 82 990 363 460 873 984 91 382
918 12 579 635 508 421 21 348 841 622 241 439 367 43 850 874 229 11 575 786
569 334 612 983 161 804 93 793 4 824 682 220 338 628 320 387 824 712 889 819
403 542 951 258 771 578 147 362 292 667 619 237 965 644 152 174 797 647 376 506
399 65 492 152 182 83 136 39 9 537 578 119 646 410 133 171 96 330 814 961
366 108 55 890 26 199 509 107 346 607 158 432 232 953 413 2 417 826 700 961
877 736 222 301 147 797 603 908 758 319 718 23 334 899 583 92 528 15 662 712
855 130 806 464 468 626 302 980 303 580 375 108 701 648 695 334 503 510 442 722
678 950 250 483 293 425 71 273 456 1 159 23 221 264 313 629 189 469 402 251
899 189 48 720 804 64 995 449 477 901 91 44 304 309 169 882 180 880 139 315
255 352 208 278 825 967 267 588 216 611 217 342 985 950 415 893 17 712 414 625
390 400 148 926 705 956 224 301 162 242 374 676 305 922 923 202 628 293 672 724
519 361 43 311 909 535 891 948 992 328 402 441 863 514 778 228 984 754 734 98
549 890 322 426 922 238 537 452 574 951 16 484 250 611 119 675 564 881 605 538
391 543 279 740 304 825 786 541 793 508 655 301 987 907 518 610 786 965 376 641
