20
936 83 184 365 633 778 290 543 569 368 793 197 199 541 627 250 280 843 66 65
819 451 852 385 940 119 22 695 909 414 222 373 493 454 862 901 315 180 400 333
544 626 836 391 82 94 20 992 226 228 746 900 633 333 532 364 596 803 614 959
381 581 750 267 869 655 665 167 758 665 35 393 564 2 25 473 972 276 309 730
778 295 150 172 790 513 784 150 901 154 282 545 645 523 230 85 933 74 243 289
84 231 993 399 111 56 222 81 695 663 974 762 484 341 805 747 126 584 486 373
309 428 388 483 326 849 259 468 245 559 446 1000 597 896 514 313 37 385 504 349
730 112 563 601 15 165 254 538 989 953 704 837 239 751 153 807 462 965 816 783
963 312 620 397 157 359 426 960 696 182 755 504 431 186 926 494 752 759 495 463
931 572 294 964 167 324 472 780 164 430 329 505 204 49 339 621 591 258 352 99
269 192 892 722 643 602 697 256 246 622 38 107 556 351 79 289 426 658 719 774
867 337 180 91 959 35 447 157 692 942 891 446 407 75 650 803 605 777 421 269
114 767 938 564 504 121 924 444 333 414 851 528 194 70 791 314 645 671 785 995
752 503 70 466 930 921 328 795 551 603 594 94 336 188 271 202 409 805 237 387
81 950 296 637 702 835 208 570 847 824 403 15 338 906 757 820 450 608 448 838
456 613 980 618 469 507 278 366 771 27 382 939 16 438 212 103 450 596 214 835
901 46 366 167 281 779 182 964 954 366 860 979 544 474 340 349 880 369 616 76
825 428 252 809 926 664 26 722 766 96 924 154 513 602 418 520 469 766 536 445
815 937 438 530 467 317 333 126 396 924 855 60 143 869 229 924 232 929 776 369
293 813 203 690 975 867 624 316 460 608 652 683 974 987 614 80 220 348 581 714
