20
343 294 358 219 999 154 682 303 956 934 14 737 849 195 213 585 587 778 283 748
63 582 462 849 234 491 695 717 67 332 312 375 191 287 793 918 465 470 971 28
565 412 188 277 303 284 591 951 165 818 759 608 103 408 215 476 354 448 997 815
492 168 692 290 90 679 135 174 634 776 160 42 648 514 540 190 584 232 504 844
136 153 310 262 988 35 326 882 28 270 998 38 160 257 210 853 139 453 375 504
10 838 33 828 349 981 160 361 605 836 400 835 511 340 39 493 189 297 100 506
135 558 715 701 911 859 963 786 947 859 56 326 187 613 582 788 4 972 692 705
579 912 972 314 32 276 307 667 473 506 347 819 96 135 148 325 663 323 958 360
935 578 657 44 526 52 392 917 489 569 751 327 480 622 514 202 276 805 629 529
739 256 981 417 174 406 921 746 795 225 301 162 767 939 506 135 452 871 120 803
568 508 11 505 828 250 485 711 556 661 528 472 461 926 15 568 39 969 849 962
487 415 868 393 430 568 252 924 425 457 89 253 46 839 821 898 286 802 208 810
324 762 74 725 176 832 346 954 935 297 580 836 415 241 750 384 871 52 204 71
130 989 320 88 555 912 652 621 158 522 631 831 918 12 820 977 67 8 827 417
345 141 93 995 25 682 383 136 643 640 868 810 879 306 664 569 519 587 972 555
273 282 277 237 334 879 674 786 855 436 277 300 74 668 743 773 124 438 807 539
508 491 40 652 629 318 477 884 391 227 47 846 213 265 116 421 709 731 198 889
90 372 27 677 471 556 320 259 70 808 894 356 589 404 541 22 98 983 644 968
460 870 735 52 813 269 369 298 342 479 655 985 897 319 957 572 537 684 334 972
306 269 131 752 191 902 543 642 452 466 946 17 116 80 729 671 695 857 179 361
