20
82 268 661 871 221 314 934 605 713 737 3 435 250 315 902 725 754 126 493 84
96 746 245 891 888 843 793 772 34 940 863 607 389 728 210 552 734 655 100 866
371 432 300 454 699 100 233 451 584 268 987 548 619 766 253 744 65 778 513 549
180 810 518 639 743 959 783 355 860 214 981 594 794 361 516 456 870 307 472 697
377 38 68 599 604 330 9 437 180 376 841 58 171 866 344 569 413 898 156 941
364 406 132 836 554 309 253 558 427 138 848 690 246 903 625 402 54 840 143 8
266 150 19 996 924 986 51 683 653 980 34 281 470 607 226 301 929 747 408 16
490 469 674 995 532 560 6 561 575 314 857 846 824 43 427 841 584 392 174 81
574 491 868 231 258 557 901 486 59 837 30 382 755 48 325 872 475 834 900 482
77 518 367 917 261 974 942 548 433 855 49 809 155 125 284 346 131 903 230 638
717 795 664 337 51 10 324 829 47 635 756 396 562 882 50 607 248 911 694 303
859 841 348 831 781 606 562 799 551 699 158 680 640 573 789 132 609 722 788 571
437 292 16 345 15 400 698 151 807 419 115 47 343 130 600 859 310 943 334 205
4 140 754 859 524 376 349 673 419 779 312 689 345 899 366 778 77 106 632 233
281 706 25 803 190 170 507 507 540 132 133 84 656 116 307 929 673 945 114 128
305 590 924 931 132 689 911 21 785 581 982 884 702 342 439 536 486 203 32 6
528 368 949 61 645 867 906 591 664 282 263 425 495 774 690 678 299 856 888 688
711 869 339 824 11 295 197 100 147 803 468 519 548 268 724 890 692 159 86 965
21 548 3 905 762 908 720 930 927 592 423 393 114 517 658 500 613 246 361 762
66 133 139 613 471 351 752 651 854 233 122 92 286 436 258 100 37 201 547 617
