20
80 267 989 263 446 211 290 255 777 78 443 522 829 168 947 608 416 10 576 124
121 781 876 491 231 440 393 45 515 123 311 56 246 35 83 861 278 854 870 355
522 499 471 65 386 474 33 310 720 948 61 789 211 155 495 323 362 865 831 977
323 328 85 445 494 968 91 237 386 425 789 986 138 526 423 21 11 847 514 301
627 320 996 799 300 901 940 198 902 718 288 794 125 892 638 765 290 368 927 291
643 868 209 948 21 581 702 574 213 367 407 447 63 828 83 611 885 308 15 942
634 879 634 32 441 817 794 495 507 866 775 252 177 299 949 116 816 315 480 195
954 630 513 589 349 253 856 147 878 593 689 725 316 40 373 716 407 481 966 879
33 62 430 701 94 273 280 296 821 427 238 31 220 881 257 969 29 557 904 549
420 49 925 132 719 642 410 932 452 398 874 405 520 793 690 971 942 616 767 75
543 240 706 415 287 536 106 591 263 935 913 635 271 679 513 726 27 307 940 783
83 830 934 305 363 655 355 69 81 416 129 522 878 890 117 853 600 960 499 883
818 565 653 361 27 774 641 269 528 545 324 608 921 503 352 153 323 813 514 790
528 193 707 229 495 263 67 226 437 50 612 416 57 718 918 51 44 742 565 451
416 150 692 280 464 168 986 160 633 830 548 622 182 828 286 836 638 758 358 257
310 885 997 998 911 489 407 852 157 536 413 889 137 981 919 774 754 101 318 166
605 593 116 36 920 541 971 822 426 493 139 186 464 168 161 749 368 966 853 145
415 661 219 347 472 939 177 833 814 322 542 100 286 422 18 551 783 773 281 739
614 387 637 22 517 177 570 789 983 153 424 368 882 160 889 794 69 630 450 431
540 621 234 897 759 354 627 520 636 670 912 630 226 424 213 505 385 317 715 902
