20
550 746 225 841 827 711 844 189 923 106 821 424 362 361 24 657 964 679 340 324
532 221 338 756 281 712 897 477 30 226 947 754 105 562 456 292 364 421 510 911
447 708 707 257 524 760 579 898 420 226 1000 413 654 793 757 582 362 989 578 126
843 323 298 665 467 662 56 631 927 692 729 791 902 821 288 923 465 158 987 909
435 660 566 381 257 599 898 72 609 394 494 183 222 758 405 282 91 145 633 720
986 282 352 168 513 512 565 310 265 302 144 392 602 480 4 333 531 154 592 290
756 540 744 254 358 759 698 284 846 312 752 427 717 380 637 480 770 29 375 26
957 621 783 662 413 435 18 110 887 677 658 420 111 52 56 45 306 495 657 207
751 328 557 312 219 232 365 665 79 139 942 762 441 368 222 211 454 538 538 450
168 732 907 939 942 477 693 788 638 437 24 526 752 647 149 345 489 104 631 481
959 511 367 633 744 825 280 342 79 156 823 228 145 139 779 1 53 723 999 431
575 867 672 111 958 752 634 392 333 36 993 744 760 45 237 786 403 381 15 467
233 274 174 648 626 747 264 356 493 430 511 263 733 649 106 178 751 70 922 279
526 605 954 427 513 718 398 384 983 380 26 540 147 469 901 130 319 716 46 156
6 999 636 842 261 658 202 567 690 867 26 729 299 411 528 866 306 457 175 945
958 494 495 6 36 876 382 555 694 115 90 535 841 519 572 311 420 808 271 950
660 208 875 699 936 480 966 94 951 445 264 815 438 589 366 665 132 694 2 33
333 598 821 998 648 890 628 651 416 58 290 169 829 355 912 245 885 543 783 374
586 122 741 638 509 815 398 376 16 857 87 294 282 31 891 297 28 386 621 92
932 278 857 291 229 752 979 853 626 311 785 226 697 765 235 88 227 514 34 830
