20
663 465 677 428 308 809 419 161 482 519 78 98 754 772 449 274 6 223 396 582
386 898 187 386 388 368 848 938 569 136 767 152 119 23 685 979 665 778 537 742
479 581 488 200 898 157 894 811 398 854 231 2 406 348 412 872 903 893 857 8
777 698 890 84 380 476 232 449 834 299 898 502 577 825 233 392 314 697 504 238
878 644 316 808 759 172 533 174 249 313 623 109 819 722 106 791 663 644 205 535
166 285 114 871 780 437 248 23 512 243 112 9 28 801 755 32 846 209 297 301
304 306 715 936 174 936 192 663 630 16 366 468 235 974 131 684 751 918 684 652
753 546 439 795 604 424 694 215 476 158 541 190 881 710 575 622 756 26 535 180
635 277 704 625 536 810 741 661 862 531 312 187 467 637 413 525 112 484 692 774
940 201 956 922 19 35 290 702 41 173 99 705 226 205 252 417 60 498 461 504
108 211 546 5 386 428 153 440 687 328 56 16 526 791 711 914 827 167 128 824
148 388 944 622 27 345 799 981 153 483 377 909 149 429 622 68 960 817 122 141
877 888 631 58 343 641 404 596 722 703 285 989 645 882 945 864 718 59 343 186
321 945 4 563 463 701 854 515 775 236 365 961 668 366 222 311 502 350 982 422
480 164 639 199 459 460 502 240 36 213 72 218 870 761 330 148 822 925 69 584
728 268 452 160 26 711 414 273 446 676 883 160 218 148 428 546 651 768 779 609
181 617 619 775 944 917 219 77 364 317 231 727 806 208 318 435 20 413 832 367
499 592 156 279 241 771 203 181 145 27 703 508 947 239 687 741 83 500 518 425
850 167 184 186 775 935 640 320 896 273 713 174 528 985 249 313 333 907 47 94
724 291 151 468 925 25 439 148 977 743 473 638 140 466 324 724 407 142 19 362
