20
675 598 243 708 265 921 271 336 80 408 861 371 836 175 699 788 942 319 892 195
287 361 950 196 961 807 228 240 860 599 765 278 686 994 25 855 304 453 703 499
817 576 463 966 149 418 378 774 46 401 40 222 958 862 866 919 711 648 801 946
529 742 854 685 152 764 946 160 997 649 513 571 228 942 879 107 366 654 388 155
672 276 146 327 650 943 832 487 594 504 321 484 684 546 519 218 732 110 841 787
569 867 372 221 210 808 860 779 54 192 677 716 548 199 92 898 388 311 76 76
101 514 260 726 10 494 553 222 754 323 68 379 614 53 645 186 565 190 101 195
981 346 545 565 750 100 621 955 231 561 499 844 102 465 872 691 323 37 328 136
802 998 360 904 677 768 740 706 28 292 217 863 747 481 825 385 211 943 660 580
638 698 305 696 125 836 37 417 280 481 687 405 454 481 347 872 114 206 187 782
858 312 809 122 537 466 342 527 34 343 170 427 987 930 271 142 309 97 415 13
471 692 282 527 244 839 944 420 190 995 741 43 572 728 568 328 494 771 19 644
532 606 622 358 185 397 304 510 70 368 93 480 394 117 810 192 879 418 638 868
450 201 46 915 436 807 773 824 327 65 801 681 47 880 211 156 158 938 59 95
36 521 99 378 439 437 152 827 207 947 36 669 584 24 352 450 118 963 109 882
580 361 108 411 434 648 725 119 818 557 110 67 98 873 243 455 831 512 42 825
880 896 617 601 976 712 477 750 864 723 243 657 294 418 622 401 385 285 509 933
608 421 365 526 35 939 219 894 118 788 26 49 682 773 431 433 103 829 348 878
57 104 952 250 229 853 104 338 97 149 40 452 899 764 786 848 485 2 70 730
101 403 608 123 51 978 906 554 400 820 678 209 521 834 368 929 40 929 205 930
