20
774 633 192 92 152 629 987 676 107 59 163 140 93 863 516 154 666 66 576 328
813 835 839 381 316 514 839 216 327 678 226 454 453 450 477 322 649 829 41 350
177 731 427 356 833 87 997 713 830 639 811 245 353 7 768 450 290 415 89 984
382 313 219 568 7 20 987 616 428 311 752 391 972 991 665 75 554 459 400 891
887 461 935 753 517 160 666 135 922 264 715 798 500 829 321 547 251 395 948 378
12 434 126 365 729 654 874 511 498 584 290 748 170 833 397 386 218 485 696 251
432 31 98 911 913 42 779 998 302 748 259 977 252 925 197 926 310 620 404 421
311 845 70 349 2 129 50 666 298 865 421 795 99 483 435 537 985 582 290 295
646 966 186 402 837 705 339 771 146 132 561 86 253 468 46 14 977 764 659 445
230 163 247 308 551 962 337 261 234 503 91 281 308 730 25 57 388 471 945 992
423 573 826 999 94 292 208 888 944 343 619 122 117 889 797 554 290 188 371 213
816 571 536 71 946 158 536 562 497 79 260 611 685 512 632 216 459 536 152 821
438 715 77 127 59 266 952 841 367 630 528 10 754 511 945 448 137 614 998 843
224 13 969 939 868 156 345 257 467 559 141 152 92 100 544 200 442 40 351 385
586 191 786 65 126 190 344 194 842 174 590 384 391 868 528 619 445 873 323 159
925 641 416 311 789 56 169 551 343 675 989 551 23 550 134 998 334 399 808 397
472 515 980 213 377 126 887 888 707 2 765 686 892 207 279 973 237 262 788 699
651 315 523 205 536 842 209 685 952 211 758 422 236 148 605 752 59 359 517 207
694 990 963 16 106 684 459 113 610 827 780 10 639 53 199 947 468 183 361 508
403 525 993 510 571 656 870 628 95 43 328 200 909 858 650 157 528 449 725 861
