20
159 910 458 654 905 663 646 242 132 108 321 660 637 804 76 407 833 173 642 379
860 849 563 721 813 777 7 98 689 970 522 740 966 951 897 931 37 982 577 838
995 838 248 392 728 718 134 655 259 835 955 445 313 841 242 741 661 491 242 415
473 578 199 313 445 781 362 131 174 639 104 373 589 823 99 765 701 201 266 597
953 513 330 720 887 106 164 317 680 741 293 549 725 573 771 103 273 885 586 601
855 921 315 25 937 44 376 476 926 873 131 314 577 686 899 339 316 26 503 921
556 714 47 108 986 689 816 472 585 654 973 797 802 1000 20 300 958 414 625 626
926 839 414 197 85 432 405 961 871 580 189 323 90 284 209 853 99 242 304 987
900 637 382 358 88 408 458 777 528 616 821 443 182 837 820 219 39 975 495 157
167 919 629 290 593 566 680 353 109 329 256 948 926 192 996 408 7 500 548 719
575 788 1000 214 64 669 341 843 769 534 261 516 149 873 516 597 71 868 827 146
423 293 857 459 748 426 941 238 771 108 603 301 242 287 451 282 469 713 584 690
693 531 893 420 958 271 937 785 82 563 885 228 478 753 538 21 121 330 203 332
360 416 631 433 451 602 374 248 340 495 729 361 120 512 815 884 978 597 257 363
780 507 798 688 887 987 143 306 122 651 416 524 15 214 523 765 485 411 695 332
817 111 482 753 976 700 966 242 859 229 728 716 116 163 825 44 597 246 887 530
852 268 844 151 493 609 858 570 467 107 873 159 666 437 297 877 474 97 457 982
208 499 635 176 672 714 500 688 714 270 403 504 35 455 238 431 916 672 182 291
726 618 51 263 295 285 175 419 930 488 838 182 66 357 491 54 712 646 856 827
935 7 760 420 138 344 553 719 318 475 167 15 951 244 164 925 311 279 652 992
