20
176 230 556 111 222 343 750 675 560 637 694 703 714 179 228 542 905 255 937 973
882 130 268 446 394 231 494 652 857 730 241 327 11 734 64 702 834 345 531 376
480 794 841 276 354 240 737 393 364 134 207 84 551 897 73 623 574 178 229 29
139 93 683 382 316 342 131 426 776 737 88 825 727 212 582 620 455 18 483 71
90 310 831 305 256 590 61 718 561 538 856 316 531 567 200 533 403 537 484 40
179 929 816 565 587 211 179 748 105 649 222 338 187 666 426 272 469 572 348 273
189 310 468 847 129 488 553 583 263 439 314 370 999 96 807 723 495 990 247 88
199 141 119 97 596 752 117 983 518 683 251 120 792 126 546 799 742 892 498 729
851 600 139 499 757 522 312 78 363 811 293 517 569 980 929 890 907 472 707 827
386 826 219 648 292 863 709 516 404 777 210 679 139 238 209 965 965 357 212 143
907 673 946 608 606 241 541 973 589 105 791 814 861 435 310 926 706 776 36 956
929 282 902 490 32 126 565 272 99 975 464 391 83 195 278 163 234 142 86 454
325 736 549 563 976 638 21 625 179 888 110 102 93 283 464 300 164 999 309 466
646 964 327 9 75 322 554 225 654 961 476 156 16 282 934 547 869 247 702 971
298 607 939 849 270 157 166 56 524 848 31 901 429 421 257 264 291 746 153 126
578 419 293 758 263 418 83 205 673 150 968 730 49 877 489 219 313 909 487 320
571 156 150 130 228 886 792 232 490 575 553 431 514 263 42 737 46 794 640 605
166 384 661 834 454 967 50 317 573 9 338 702 350 189 663 905 257 422 37 874
1000 535 931 24 795 246 368 523 483 13 301 299 294 632 625 343 561 219 805 97
984 35 13 615 590 619 597 978 101 655 18 72 318 594 388 703 660 717 951 168
