20
129 372 920 831 565 377 586 483 24 93 379 949 713 483 384 474 839 808 707 120
8 349 415 428 230 439 189 35 516 382 774 625 108 835 813 157 308 988 301 634
607 835 868 966 125 538 875 327 363 397 700 963 549 78 105 74 476 15 543 456
347 541 764 323 747 988 23 212 740 447 955 209 153 603 352 168 412 67 154 284
377 17 923 672 698 881 446 355 914 463 468 361 350 172 806 680 999 218 60 261
772 91 493 370 325 37 470 238 874 663 540 558 577 219 677 579 596 769 612 288
108 670 98 377 91 261 29 101 464 8 181 206 510 251 771 388 260 241 230 171
124 780 869 189 246 923 178 284 222 524 683 624 523 357 86 785 210 440 62 820
82 541 335 449 743 563 726 201 572 623 814 178 476 769 811 207 838 537 24 110
955 804 727 441 748 59 567 262 271 505 611 445 28 112 202 373 802 969 895 825
357 380 334 602 28 13 300 968 387 450 105 365 206 333 499 282 101 295 290 573
815 636 509 628 724 397 31 705 420 226 900 475 970 551 454 752 793 569 169 779
217 535 240 455 252 135 531 647 686 227 680 806 510 768 243 866 695 7 459 667
757 65 904 253 810 629 739 435 633 92 489 60 300 674 216 951 470 829 158 799
298 242 13 703 122 953 129 604 812 819 997 168 9 707 482 558 384 263 373 683
1 117 630 348 805 227 476 693 638 617 21 417 711 135 104 591 482 361 819 627
572 810 851 182 873 344 246 186 298 250 311 571 199 737 634 467 903 878 11 665
236 97 336 293 470 543 985 636 375 322 506 886 503 194 768 819 387 695 691 877
83 113 880 987 537 152 571 28 462 755 239 866 436 444 572 788 468 753 908 323
20 362 580 108 174 875 141 537 957 870 815 46 250 389 652 541 27 31 115 58
