20
147 219 11 49 286 145 938 52 597 184 69 879 69 812 130 849 786 868 493 13
556 477 550 156 65 203 446 447 219 247 572 403 536 88 876 257 419 791 787 814
936 289 103 786 799 608 986 520 559 416 326 308 535 392 356 136 816 526 148 863
70 315 242 216 651 955 481 634 182 681 250 844 940 487 850 363 366 10 129 928
517 481 1000 979 129 106 485 569 288 224 835 603 544 929 571 353 287 450 949 595
979 215 862 654 979 97 214 128 905 205 521 715 45 925 570 731 145 261 800 482
427 78 73 443 83 966 373 913 447 109 930 627 260 736 383 82 392 987 621 802
617 597 821 561 559 83 376 421 14 775 73 258 659 793 439 743 104 179 88 352
338 835 183 157 826 339 576 742 733 901 238 276 158 321 536 203 820 859 267 693
411 609 228 435 693 700 302 75 925 182 707 21 919 427 452 511 931 692 407 428
650 378 30 349 83 380 522 108 272 92 157 748 410 94 153 114 848 767 517 957
360 688 362 177 302 278 676 154 400 636 323 402 351 368 470 875 310 574 982 822
148 271 336 18 628 448 397 579 61 155 319 385 932 575 326 5 16 898 697 920
600 190 18 198 914 220 189 841 909 655 514 495 123 682 31 213 296 200 12 577
747 583 36 841 10 113 1000 225 445 510 358 166 988 551 31 5 464 403 106 995
372 972 221 435 384 645 583 662 541 764 12 137 70 467 259 688 855 858 794 980
559 745 949 831 379 138 300 299 217 683 378 877 181 889 929 865 118 227 509 763
524 685 353 979 429 65 506 105 884 182 720 922 141 161 454 2 173 451 345 64
942 66 15 294 39 938 460 501 209 80 874 872 609 892 966 931 510 902 666 316
238 597 847 702 492 379 972 22 419 448 785 308 993 477 107 458 458 836 842 97
