20
379 225 25 250 950 321 444 178 99 562 126 839 173 955 552 742 374 633 600 417
34 763 185 745 467 402 425 826 791 780 801 211 124 482 823 152 146 778 538 984
540 563 240 300 769 557 994 64 166 374 327 510 487 697 816 198 203 108 135 886
389 323 277 317 641 195 182 523 865 433 758 220 384 64 990 643 626 750 299 891
495 479 519 86 697 353 665 101 626 724 991 792 945 40 19 483 708 733 188 145
108 733 143 542 450 806 32 212 53 844 425 194 376 748 681 99 880 660 507 981
968 739 425 814 864 726 488 47 483 25 578 527 593 587 597 102 961 384 293 348
703 380 51 578 311 983 674 153 569 513 361 690 814 812 793 218 64 875 965 445
411 469 380 84 372 247 3 196 290 669 502 283 771 114 86 434 988 929 271 609
503 203 149 623 283 443 911 371 241 583 471 749 796 352 248 468 53 622 755 196
326 605 833 899 807 223 656 187 477 185 987 944 306 964 968 876 290 953 332 776
394 275 340 54 160 866 146 549 392 6 991 193 385 785 63 437 740 228 192 710
645 356 124 232 761 632 329 138 814 433 594 142 646 688 483 752 139 454 339 395
682 230 260 324 826 477 684 338 907 258 921 425 472 487 802 728 324 328 815 51
327 699 879 954 868 96 345 66 570 772 274 597 388 776 705 794 633 627 537 939
431 360 112 944 463 201 547 945 553 845 850 990 718 128 190 94 453 961 334 995
397 316 733 328 253 426 969 273 967 151 929 213 393 258 549 659 764 790 335 808
214 235 574 758 427 659 206 996 38 259 18 43 999 864 859 523 709 547 150 71
975 384 6 75 448 106 913 508 399 599 177 201 840 961 511 451 544 763 278 104
168 981 563 249 751 973 756 400 465 90 337 658 356 920 561 625 361 61 362 608
