20
207 717 690 582 65 616 310 24 792 292 946 508 492 6 321 978 845 211 608 841
315 206 210 903 175 650 572 886 718 809 319 484 64 104 818 317 959 198 858 991
155 40 378 308 730 650 269 396 58 126 174 377 793 704 160 608 985 281 15 368
188 25 801 492 703 192 538 95 282 66 910 163 52 988 888 190 881 737 223 22
766 208 506 315 954 567 564 88 502 443 660 369 209 395 65 503 371 799 840 111
100 271 952 270 949 614 629 754 968 878 248 779 111 479 907 457 491 812 166 665
230 755 492 935 382 588 91 987 733 948 182 473 296 554 963 302 704 636 745 965
402 717 481 304 112 297 356 645 168 572 231 140 605 732 745 850 299 70 838 865
875 603 162 504 30 188 477 925 752 265 498 615 969 748 453 816 218 252 984 693
758 284 619 711 153 139 956 323 986 412 603 261 321 724 303 157 513 224 294 716
681 817 93 226 919 442 932 275 778 912 133 394 792 335 514 21 251 314 114 884
957 548 828 912 907 298 104 951 125 727 230 210 668 508 91 580 34 966 744 510
927 863 889 388 84 738 585 268 920 997 308 596 762 742 619 676 317 110 992 752
957 97 353 457 82 32 465 352 917 783 324 215 356 329 171 613 598 309 984 818
201 929 905 601 373 968 112 494 379 557 933 476 551 563 423 261 270 280 841 312
17 312 70 888 365 277 409 785 259 657 320 185 447 131 491 986 671 220 184 110
943 216 931 713 583 988 931 982 287 982 840 137 475 818 198 143 437 595 239 818
586 828 568 190 405 572 867 432 958 177 602 854 119 45 56 716 285 299 936 938
170 962 463 541 649 36 743 518 142 312 930 44 763 209 939 52 259 177 149 893
432 7 239 304 659 140 51 140 409 452 656 498 799 982 407 222 317 824 751 245
