20
10 775 493 845 355 75 140 264 581 291 381 467 257 45 965 135 634 840 211 837
325 146 932 354 200 997 635 317 612 738 172 691 874 638 414 572 349 880 709 838
88 562 539 515 83 840 618 957 113 400 638 522 530 598 131 168 22 706 874 764
730 588 978 114 77 281 524 352 841 294 367 649 35 789 485 175 666 554 647 524
322 489 899 418 910 873 50 878 976 461 986 193 865 470 157 369 782 959 69 199
488 836 847 488 219 40 64 906 770 557 106 53 381 73 923 944 12 454 842 339
528 441 837 662 305 997 205 872 802 459 494 439 853 958 199 401 901 964 826 844
475 337 483 991 194 928 416 978 655 150 989 787 184 805 781 216 594 555 705 783
700 430 496 126 167 41 250 6 218 175 612 894 400 122 664 461 8 430 85 397
319 670 407 621 911 134 287 164 710 704 857 600 779 934 724 490 303 757 832 927
230 557 490 634 993 374 521 699 392 381 213 125 478 767 107 160 545 621 507 300
631 217 641 447 588 746 248 698 791 502 905 992 899 267 652 510 618 618 634 708
202 66 843 656 436 747 530 733 699 637 461 724 551 404 868 594 678 535 147 593
948 480 182 193 62 978 491 292 705 489 617 689 68 653 412 53 299 876 279 378
915 274 586 199 856 880 891 30 14 410 929 992 567 595 412 229 276 394 757 729
614 926 919 134 109 202 98 386 797 875 125 450 875 787 357 431 905 653 704 122
476 603 204 19 384 769 484 745 550 196 80 692 589 220 322 155 177 753 14 925
357 34 398 748 627 915 563 410 445 387 375 293 4 603 374 376 888 657 86 403
61 681 523 344 771 799 369 36 57 725 35 49 153 7 551 531 518 955 393 580
659 919 746 11 127 368 502 122 986 275 775 622 735 618 709 975 928 193 972 177
