20
519 967 332 265 11 987 896 224 967 772 686 668 385 431 757 442 824 67 762 329
929 474 813 246 79 616 48 603 211 709 763 233 992 177 268 450 843 593 393 607
433 818 450 132 788 320 933 997 661 728 735 793 147 783 765 206 24 207 363 263
141 165 715 85 359 94 248 882 507 89 889 784 692 286 832 988 848 819 1 849
793 975 719 944 131 419 443 379 853 192 181 818 989 982 591 818 914 241 889 382
498 462 664 944 181 42 893 919 484 536 423 689 902 984 868 347 161 865 402 968
902 257 813 78 689 41 330 140 482 480 224 13 975 762 556 972 884 658 53 200
290 167 462 488 184 278 41 45 318 428 870 703 590 498 498 273 426 774 888 140
24 314 328 803 463 293 21 146 586 846 909 735 853 100 589 545 149 445 170 631
456 966 217 382 242 648 143 790 343 36 302 856 201 327 196 797 306 58 529 832
76 530 534 772 493 231 320 45 362 687 33 743 408 360 303 658 964 168 754 164
44 230 806 968 827 167 193 92 892 151 538 321 437 323 564 787 348 322 97 367
475 946 420 578 320 220 638 865 463 100 388 527 934 534 311 75 665 955 742 256
477 837 438 294 15 222 278 825 289 21 64 404 930 241 221 69 331 777 10 540
885 614 668 148 333 736 328 358 527 509 558 227 465 72 899 418 749 768 748 789
196 818 522 289 239 578 976 33 803 317 505 623 305 814 414 265 885 637 518 932
612 248 991 824 891 595 407 199 285 118 42 613 884 790 536 482 259 783 212 368
982 727 311 758 465 932 225 712 245 437 535 939 31 521 111 423 809 437 130 619
36 694 685 763 826 997 787 396 519 883 146 565 841 97 154 37 55 476 680 542
861 320 285 140 568 58 299 64 490 118 921 392 902 375 237 629 973 433 497 439
