20
687 75 794 964 974 612 254 168 994 964 387 654 65 455 939 545 78 64 330 541
367 396 508 394 918 103 497 354 677 201 644 201 100 770 805 343 281 360 549 793
579 399 861 8 907 476 938 937 444 685 619 56 950 46 131 958 35 365 914 671
376 781 32 559 988 479 978 743 66 154 438 459 323 574 269 479 991 898 704 267
208 133 621 955 948 544 18 988 864 186 338 138 514 432 544 909 274 657 523 82
500 373 544 859 44 319 169 464 399 867 997 424 510 879 743 18 167 174 866 22
692 433 223 417 168 518 535 112 755 278 781 722 383 598 426 524 565 759 954 354
625 230 448 5 631 120 101 494 676 730 213 468 482 682 497 253 479 988 652 967
118 133 208 502 475 431 343 310 41 657 346 439 43 800 699 162 920 703 50 449
133 328 23 425 175 128 459 226 859 281 889 494 656 507 926 706 621 885 877 576
270 601 310 44 186 44 827 1 422 684 852 423 941 540 66 841 734 781 357 583
535 308 850 133 277 321 434 273 447 275 139 350 506 396 571 996 207 678 574 196
115 471 242 891 319 2 274 861 777 99 745 302 67 879 106 576 125 175 365 958
648 255 304 732 984 36 862 99 172 379 822 291 263 668 137 704 100 833 199 938
9 409 892 43 187 620 817 273 424 634 856 71 733 397 386 888 132 614 976 741
826 388 15 997 406 115 689 583 69 239 38 801 264 333 461 226 295 263 578 811
757 182 631 276 177 927 235 620 661 73 930 406 376 432 180 921 306 211 975 970
985 572 220 582 184 307 382 109 545 462 31 701 937 738 56 187 745 248 901 447
195 161 744 475 396 905 509 420 626 992 468 735 719 731 302 332 609 442 80 278
275 40 413 683 626 6 302 852 720 931 395 591 851 688 819 129 752 191 993 675
