20
641 485 750 501 101 303 607 399 459 552 971 364 374 893 253 506 968 969 693 462
977 248 944 527 168 799 231 170 944 410 114 602 892 636 878 152 849 433 692 567
912 830 678 941 554 970 139 366 662 686 951 845 292 241 523 78 585 399 847 763
849 476 942 248 238 203 398 131 809 388 31 365 73 425 399 231 558 364 234 556
103 764 254 798 330 596 462 471 470 179 85 957 15 704 410 809 931 118 129 119
263 981 926 650 804 787 261 186 304 214 730 316 882 640 144 948 781 700 551 830
58 145 992 652 741 488 853 797 373 451 157 519 951 354 570 59 407 417 324 786
302 161 145 651 437 267 88 64 513 691 804 323 691 916 291 651 318 172 954 935
257 762 264 547 999 102 155 804 815 706 848 622 28 585 617 785 735 83 3 200
958 840 265 75 621 782 468 955 272 380 56 87 759 630 380 469 824 912 510 343
394 512 493 443 536 200 166 388 410 931 209 811 449 107 771 72 794 837 387 219
184 912 419 406 947 217 782 644 43 710 610 989 465 293 669 773 828 441 560 159
900 178 350 757 354 867 698 991 312 912 353 227 152 395 82 505 455 175 202 547
550 789 460 444 459 625 22 920 946 185 848 614 723 207 187 77 992 108 986 995
189 734 980 415 349 542 951 259 24 941 684 720 144 992 858 792 308 677 117 42
896 724 943 219 495 817 533 74 627 33 405 206 136 523 167 327 634 183 150 965
242 232 878 131 472 408 742 722 444 424 182 842 174 240 574 106 849 128 465 675
26 569 308 401 70 748 884 209 879 903 49 169 652 817 799 514 459 986 478 756
286 395 869 280 620 988 383 967 83 340 772 888 923 923 126 991 926 801 911 140
575 45 290 86 684 795 234 431 641 279 421 763 547 667 554 18 895 260 658 450
