20
128 291 547 994 655 475 26 282 182 434 504 87 801 111 602 999 716 672 17 176
50 90 358 191 965 440 329 408 191 911 382 421 531 925 215 863 221 906 335 829
574 460 171 941 33 994 717 386 294 762 671 303 292 736 470 486 443 854 545 94
550 901 239 920 783 319 912 125 545 272 788 685 897 652 252 953 894 453 995 183
782 248 552 624 253 159 623 95 1 408 866 795 926 242 665 560 160 950 274 410
459 67 506 454 538 807 917 493 883 776 629 179 130 420 561 407 719 599 846 197
691 47 914 507 318 277 42 401 621 741 513 134 765 414 480 921 83 689 3 634
349 331 755 520 347 113 544 963 806 371 480 565 400 197 559 451 746 499 38 824
692 912 931 901 309 163 321 100 962 141 439 582 158 190 92 458 378 112 169 402
845 718 871 632 928 419 23 707 481 948 594 816 701 852 309 768 54 341 977 218
446 119 456 66 15 64 467 20 893 485 916 839 741 896 367 339 853 39 527 221
759 159 180 753 307 165 923 451 233 709 86 982 492 414 949 871 54 22 879 850
249 251 68 166 522 430 839 745 307 574 408 733 494 417 994 275 696 934 276 234
98 581 352 195 916 818 603 359 52 235 512 608 620 319 974 775 859 375 845 343
673 756 93 258 94 420 989 972 46 797 100 881 470 571 861 924 308 392 711 845
758 843 461 474 935 952 142 707 177 766 474 502 31 505 769 499 893 330 131 497
577 954 797 691 148 81 420 275 58 454 74 167 700 318 602 305 870 456 294 335
72 742 740 727 120 262 377 544 436 382 961 764 718 234 12 65 55 936 731 703
884 130 349 282 888 263 228 852 516 401 599 76 58 55 509 726 508 665 428 576
108 680 597 485 652 422 528 162 983 778 723 386 698 566 393 798 479 745 384 849
