20
663 925 634 384 953 256 696 123 417 919 930 565 233 450 29 660 683 902 325 967
50 481 480 298 947 653 8 271 242 75 796 168 194 471 439 367 672 417 632 26
906 629 607 872 270 145 359 545 751 413 233 662 366 217 225 599 806 403 847 875
512 885 156 895 85 64 636 433 271 138 809 557 822 231 101 591 78 411 736 979
803 196 94 929 137 483 290 62 935 242 74 980 57 143 483 910 549 735 773 415
352 177 950 179 84 666 905 267 563 446 482 200 397 702 980 140 474 595 388 722
327 694 801 741 989 843 845 58 169 272 23 367 987 788 444 511 513 328 284 711
703 449 743 79 808 653 780 713 279 556 837 449 285 707 609 610 488 201 244 94
391 333 653 678 25 526 260 255 833 478 237 272 739 52 893 875 441 794 112 151
176 640 419 150 312 38 700 390 233 529 743 621 162 874 389 124 402 231 103 434
209 455 809 167 261 228 244 258 302 194 690 154 760 372 332 286 922 79 942 669
298 500 973 729 977 657 328 588 627 55 523 558 207 486 126 55 435 82 992 362
704 606 601 728 362 736 248 918 526 259 873 769 639 990 559 102 833 400 518 355
524 318 304 640 96 40 964 572 779 238 391 505 884 737 713 895 555 444 15 599
451 844 302 581 529 327 353 902 602 158 856 150 839 707 5 221 270 309 782 845
228 220 221 904 956 267 60 69 253 227 334 834 413 210 14 996 182 664 940 362
148 835 478 314 913 423 365 749 803 604 976 399 957 60 582 104 885 165 46 420
733 163 747 6 370 542 895 433 399 655 363 434 147 535 166 900 399 778 659 578
245 381 154 678 590 905 105 971 835 433 430 559 389 469 383 491 814 962 194 818
211 780 698 83 897 195 133 338 564 591 711 631 174 565 922 6 719 662 309 261
