20
571 955 670 927 392 767 665 706 683 679 924 136 905 322 104 308 462 369 563 393
458 638 176 879 422 149 730 499 77 747 945 827 826 380 170 781 779 534 206 416
461 194 144 503 318 757 296 236 618 494 939 738 197 314 327 711 338 243 946 501
774 676 964 115 453 217 652 473 991 300 6 975 597 465 216 964 342 675 793 437
764 812 383 308 409 830 650 875 935 356 33 647 55 260 485 989 83 116 119 29
806 306 927 467 85 118 816 755 310 819 405 905 141 568 74 94 874 616 126 315
953 138 889 696 820 693 787 274 438 80 542 362 750 108 834 924 125 190 304 804
525 32 46 96 179 250 938 565 505 741 866 12 38 915 384 58 96 218 807 950
628 384 774 93 186 878 8 654 21 381 627 979 938 987 913 995 695 443 397 657
340 179 662 254 446 108 327 851 424 507 36 186 335 955 907 651 572 643 235 814
88 517 543 760 134 810 142 223 37 16 347 502 509 98 510 785 716 811 368 748
384 82 82 523 918 540 468 997 112 621 63 637 203 545 516 751 169 540 270 805
561 267 933 874 461 591 653 499 707 780 780 824 343 674 656 298 505 491 102 533
226 123 810 44 96 890 138 182 779 274 419 657 834 264 778 170 113 275 802 560
999 189 183 51 667 830 854 150 659 513 975 157 264 787 9 334 166 564 60 780
999 819 750 772 29 368 171 588 899 219 49 965 745 842 492 122 523 616 640 756
444 171 373 346 525 938 587 352 261 503 366 956 872 457 808 131 529 48 878 732
253 410 159 605 250 481 951 570 917 761 107 194 950 844 613 819 895 826 176 628
646 383 5 491 985 423 50 820 239 646 421 764 785 680 9 690 4 107 986 390
194 857 105 513 323 1 247 279 545 656 351 905 269 896 762 597 706 348 990 734
