20
911 285 715 385 863 218 327 448 247 348 728 772 869 50 925 286 356 892 715 778
838 723 966 812 860 973 432 429 1 918 366 625 979 205 807 854 317 245 91 88
155 944 118 784 576 811 214 946 476 447 166 630 739 31 678 511 147 374 560 248
450 387 114 761 951 786 736 165 889 50 467 659 371 674 658 532 539 567 143 738
114 754 327 725 979 570 722 477 775 809 392 780 421 541 74 392 287 377 204 107
544 698 126 503 753 709 321 8 8 100 735 510 427 341 630 917 527 811 687 309
82 641 619 873 13 92 363 336 135 788 429 67 189 491 531 40 111 727 115 339
31 152 639 104 125 189 760 152 273 994 844 765 559 403 913 462 136 619 298 657
260 188 446 41 48 834 157 608 260 509 115 521 543 248 119 397 701 836 879 387
249 571 479 537 843 267 578 838 979 688 514 306 535 325 989 981 452 931 506 568
642 406 201 136 285 430 367 648 414 7 887 862 61 484 281 799 540 946 801 927
918 148 460 811 326 641 715 130 862 526 399 636 708 416 63 118 76 768 468 879
7 716 785 25 633 39 607 862 694 296 706 340 266 823 940 603 257 801 560 719
5 911 227 155 124 96 526 244 324 132 651 178 826 705 175 117 406 754 378 155
736 669 743 865 142 16 175 797 180 491 669 925 135 410 230 248 820 708 779 617
257 473 285 541 313 16 908 861 491 702 840 776 810 721 490 126 52 265 577 842
86 587 806 458 498 819 747 47 837 960 288 636 610 750 978 405 591 661 919 944
522 938 46 524 123 378 151 14 575 230 560 315 822 592 400 835 541 942 781 946
580 660 197 469 519 675 480 986 277 637 137 259 414 102 776 616 219 437 935 829
996 262 54 655 347 131 895 10 148 710 330 214 296 804 296 457 873 295 990 41
