20
982 720 373 714 69 41 705 714 294 979 228 617 18 726 35 765 48 323 927 219
560 123 406 613 739 618 10 689 626 621 687 968 101 742 610 682 987 866 578 623
200 194 379 853 540 627 740 120 506 166 615 289 919 776 317 170 561 923 881 649
44 200 497 56 325 452 613 317 209 911 644 402 884 346 898 663 755 898 782 637
340 718 673 42 191 510 73 507 55 873 79 880 151 770 152 398 820 759 790 840
854 515 435 350 80 641 679 443 593 845 265 637 126 919 106 123 498 558 845 887
824 226 718 161 858 288 448 153 428 355 684 243 449 833 667 849 271 690 951 610
602 584 776 399 531 359 508 258 610 786 510 106 416 606 475 389 6 491 164 524
151 432 741 422 958 662 89 967 216 349 873 764 690 352 171 674 81 820 947 870
555 674 100 726 962 6 400 251 82 428 519 750 559 642 528 75 546 936 838 55
467 319 425 146 303 108 970 248 373 870 728 232 272 368 240 694 8 722 355 596
101 390 704 453 570 593 59 569 724 685 533 577 834 92 521 91 714 213 969 622
644 59 78 380 22 262 396 970 349 713 878 512 552 803 571 101 531 796 815 968
556 513 861 794 257 667 136 504 6 604 311 500 491 892 583 569 345 865 801 816
718 274 931 670 443 116 788 580 748 412 929 213 944 266 385 122 136 677 226 56
539 578 651 984 159 985 120 121 759 312 890 9 966 196 442 214 539 720 606 464
777 74 210 314 693 678 664 131 69 972 941 342 876 291 60 517 445 970 141 475
449 911 659 579 390 608 887 825 825 183 20 607 134 124 101 141 182 220 806 709
1000 587 612 49 522 161 79 696 427 698 537 446 467 277 252 416 391 213 108 491
473 81 443 112 173 438 925 74 137 504 874 598 476 396 835 240 731 577 642 775
