20
279 900 994 503 404 181 121 365 144 550 374 969 156 780 653 831 523 726 878 466
226 227 187 576 524 290 50 799 931 145 51 676 295 793 230 278 291 83 843 769
247 536 773 920 554 765 172 703 491 920 21 536 42 101 311 760 994 668 499 490
970 415 161 654 507 374 330 422 50 295 106 504 435 994 910 722 934 291 742 19
49 75 916 174 760 390 858 874 332 310 57 373 412 49 556 712 637 959 598 181
694 646 750 446 33 962 273 125 868 766 399 806 415 797 42 770 186 948 540 934
846 366 833 833 282 872 663 392 474 157 180 461 626 415 25 634 155 78 372 998
843 733 749 518 410 814 534 550 415 55 859 827 345 606 252 910 616 13 520 989
992 495 96 315 71 397 128 771 243 232 32 646 883 709 932 905 875 887 467 61
767 272 498 196 835 194 649 192 385 667 115 921 200 565 949 899 212 676 4 387
892 832 756 888 178 969 241 841 738 745 473 760 28 768 711 180 473 275 485 1000
109 430 272 800 892 147 845 538 629 720 923 444 474 914 151 801 732 575 576 636
786 325 535 560 47 620 180 577 156 29 45 343 642 619 302 40 225 808 392 554
772 638 461 648 403 789 966 556 558 794 774 45 564 798 1000 166 757 575 790 714
43 15 874 39 425 563 770 587 831 382 577 889 852 721 138 646 617 165 685 463
564 884 547 436 492 537 735 944 540 485 666 489 308 63 98 20 456 65 347 524
569 56 478 755 136 414 38 208 599 77 219 37 956 42 411 464 16 29 308 662
641 16 512 17 549 688 806 254 651 866 914 33 650 82 123 603 431 862 374 970
769 304 665 548 701 887 699 864 698 882 595 608 660 150 310 478 10 81 734 943
434 927 50 27 952 593 150 365 200 16 120 607 273 918 463 103 969 822 143 624
