20
617 35 476 699 721 945 893 123 600 914 135 783 935 837 447 891 546 915 431 991
770 808 21 2 914 835 15 621 855 526 350 207 209 937 587 941 726 128 775 365
639 876 354 172 194 581 473 398 953 261 828 688 992 149 413 309 924 930 892 969
910 818 737 897 142 500 963 454 316 387 334 402 301 208 415 119 244 43 723 925
726 240 134 882 295 911 830 456 934 46 224 819 253 144 949 108 993 69 867 673
111 755 569 373 805 775 340 966 148 506 859 25 673 940 763 3 944 16 968 530
743 315 573 576 448 312 400 562 614 535 38 970 927 193 46 641 257 17 766 645
964 610 73 572 335 542 270 993 33 452 418 566 409 916 32 928 655 742 203 372
705 245 724 495 273 892 55 410 676 577 238 595 69 903 647 537 130 973 896 109
344 456 836 700 128 533 343 263 960 967 150 206 250 638 353 691 156 353 204 502
105 334 335 540 996 61 875 449 822 630 333 683 940 288 168 601 104 988 127 40
922 131 8 329 383 430 616 92 466 375 367 517 867 735 788 419 611 767 451 770
98 475 92 768 542 187 182 331 257 37 255 524 689 562 893 276 699 144 309 534
233 799 639 808 417 532 393 307 462 583 676 92 201 601 986 796 633 270 766 284
203 910 825 908 54 349 278 32 531 756 115 113 435 995 117 417 149 688 400 556
247 290 665 617 373 609 259 991 792 819 925 36 630 792 733 642 191 168 555 459
579 189 524 568 784 620 18 900 569 390 947 659 965 23 570 16 329 246 604 143
874 725 145 723 456 911 70 445 61 735 32 436 396 790 851 417 890 662 68 443
914 655 570 234 569 101 814 286 943 522 904 14 100 611 466 48 20 862 983 171
221 223 331 605 650 237 529 558 876 500 607 421 911 385 420 49 904 340 986 347
