20
313 487 497 695 817 145 133 275 120 846 982 742 766 906 900 730 736 123 422 713
129 111 556 143 947 13 75 134 81 737 993 346 742 904 661 778 693 354 946 809
549 836 519 424 808 655 682 862 129 115 558 616 331 864 330 835 96 166 60 931
851 389 60 855 417 655 789 727 81 801 586 147 3 996 570 478 297 393 706 197
523 379 583 974 971 867 203 674 118 193 731 822 986 275 340 360 867 181 901 76
615 106 60 697 366 886 514 52 963 172 934 571 193 918 375 864 70 42 782 504
158 647 657 586 982 862 13 19 318 695 765 284 245 830 392 796 256 226 247 624
721 279 957 72 223 197 947 479 654 465 372 989 69 689 710 958 15 30 736 284
28 208 488 562 30 138 621 625 434 923 590 419 374 98 781 254 299 778 457 721
803 491 152 822 388 249 404 391 255 545 592 997 559 549 410 190 964 526 640 778
862 814 483 853 249 561 291 866 321 772 720 478 703 689 903 115 309 260 272 537
946 567 366 101 484 13 76 5 5 772 625 365 2 788 336 355 57 68 125 740
295 410 461 163 133 978 530 124 426 933 660 421 299 324 731 447 54 571 624 754
77 665 544 565 257 57 231 819 666 209 71 47 623 368 465 493 696 489 295 105
840 300 986 855 30 790 759 480 480 17 745 530 250 103 849 147 176 29 230 940
732 725 335 19 519 502 803 897 248 168 268 915 666 40 274 449 317 509 495 65
414 827 464 402 650 147 772 574 723 417 943 425 977 859 598 593 32 683 364 497
60 352 604 985 624 837 767 748 391 93 849 708 128 623 310 445 366 95 862 887
918 214 221 14 233 30 893 675 333 452 835 932 438 316 362 455 258 890 575 255
54 975 95 461 945 191 408 330 340 159 351 91 558 885 439 220 378 659 175 295
