20
648 695 838 979 532 700 823 548 320 716 378 37 639 858 520 496 110 796 208 46
760 31 880 127 898 467 53 981 961 24 336 869 847 216 294 649 112 257 372 426
905 448 31 59 559 779 704 848 221 919 867 510 262 68 108 187 551 704 61 862
407 28 451 314 134 538 240 947 516 255 647 604 868 488 705 861 901 558 919 954
277 769 308 451 319 690 682 306 354 790 767 519 11 10 718 84 137 652 146 884
175 155 354 761 409 814 627 657 35 29 590 687 866 990 866 67 614 40 577 262
811 335 511 274 422 681 903 702 845 797 505 515 716 972 378 422 755 628 709 300
947 798 306 511 411 243 894 443 489 460 125 559 309 261 528 548 221 274 552 852
519 722 142 143 490 805 596 13 455 268 807 179 177 57 658 267 428 755 295 425
661 845 584 418 598 307 93 868 95 378 965 344 963 330 993 751 600 552 702 868
212 887 516 33 782 500 788 88 955 36 763 642 99 489 757 711 550 961 206 107
837 815 654 922 47 251 539 976 759 623 215 22 719 209 46 975 872 633 668 183
934 251 731 27 165 411 514 703 268 739 206 247 410 334 624 203 788 188 669 954
452 433 336 159 456 913 332 282 190 79 499 813 227 510 599 355 362 890 284 912
300 517 838 608 725 394 522 83 967 646 974 737 907 946 285 386 510 680 811 374
247 609 208 60 822 576 522 159 660 696 440 713 748 923 149 900 219 880 745 94
605 851 974 214 595 635 223 607 757 578 305 934 55 881 580 455 722 578 8 542
799 105 827 439 79 369 336 796 617 452 739 151 139 313 264 917 219 550 343 440
355 841 724 71 857 359 733 503 32 954 878 249 619 281 535 368 778 226 67 12
426 743 274 743 289 186 182 847 733 914 326 136 369 146 826 864 806 596 647 154
