20
632 682 264 752 949 434 586 446 236 847 847 953 54 604 825 876 845 120 94 478
357 32 149 393 993 369 290 141 99 419 359 298 344 502 948 440 250 420 152 920
117 704 117 606 991 344 143 453 170 236 472 269 362 545 339 215 949 192 135 21
326 511 381 368 998 160 681 522 70 150 7 943 772 252 262 200 46 487 881 991
591 239 887 885 899 793 751 414 479 98 392 628 704 490 575 437 610 234 437 211
213 610 144 251 739 144 434 474 304 657 718 358 263 268 246 686 506 854 415 367
269 418 595 865 672 785 879 416 298 149 401 520 270 659 622 983 927 512 297 463
916 817 292 21 773 851 427 537 491 353 469 110 516 344 876 131 414 981 666 856
927 794 68 988 494 392 514 48 130 481 529 779 15 682 330 951 421 752 832 898
143 175 989 812 632 942 490 330 259 655 609 702 178 205 112 712 164 500 900 729
875 452 965 725 439 998 741 592 93 559 48 492 796 717 623 946 215 349 298 830
733 995 760 676 160 998 551 326 243 87 33 254 327 825 253 685 786 592 467 108
846 996 439 675 275 823 754 894 448 797 256 626 438 820 785 463 187 493 587 112
208 301 187 743 793 145 615 373 705 82 107 646 41 106 948 861 263 352 420 867
773 379 51 586 649 803 70 775 192 122 308 949 708 832 973 962 283 516 677 630
212 141 419 145 840 921 188 776 46 262 502 415 854 964 664 722 830 31 516 98
90 447 469 568 798 853 130 449 330 310 67 367 721 663 364 968 237 328 356 268
638 596 917 548 744 633 662 13 119 752 40 119 16 746 387 481 331 711 620 526
207 525 128 195 33 423 243 45 26 564 744 914 713 771 886 777 11 595 101 832
193 278 61 404 601 847 216 269 625 29 309 58 1 267 369 759 230 882 93 210
