20
567 423 503 343 616 81 898 948 163 649 911 932 548 166 76 793 518 932 391 89
16 594 949 617 581 460 533 817 267 907 168 11 458 267 33 370 498 798 409 248
914 76 865 675 678 331 652 731 856 21 864 910 295 305 395 509 260 429 30 1
12 352 362 370 300 943 258 419 567 66 54 830 699 118 715 220 534 848 612 572
188 535 469 72 584 503 292 767 918 129 246 951 523 36 249 42 929 986 756 45
423 784 478 303 966 661 284 518 347 352 325 604 380 214 768 963 265 707 443 942
447 124 974 834 495 702 947 780 621 714 485 758 780 746 173 881 118 876 539 603
319 380 800 482 963 414 96 598 428 172 185 779 435 744 796 294 695 534 575 101
327 209 614 665 189 868 652 466 14 874 879 109 752 411 50 826 731 368 25 913
376 748 119 552 297 194 821 713 563 384 14 337 41 904 312 926 488 507 814 246
86 208 112 764 969 112 999 944 117 247 249 105 34 156 855 440 181 954 133 786
581 118 90 359 948 414 105 305 957 236 697 188 179 861 247 409 501 127 637 404
257 459 875 961 151 420 757 143 449 31 258 644 917 7 146 456 825 514 196 822
719 646 911 473 912 224 845 652 894 710 974 139 455 163 364 422 775 243 975 64
909 145 117 391 902 241 219 623 525 957 828 339 528 518 538 998 905 694 888 864
970 49 978 113 629 983 963 248 336 378 724 57 253 61 907 811 211 262 476 912
450 269 571 745 93 125 808 573 136 800 880 548 803 886 179 315 157 515 757 563
606 882 948 775 40 427 268 918 453 242 630 162 12 632 475 336 393 503 770 172
513 254 75 388 940 111 839 539 486 742 826 235 802 672 758 660 123 851 12 13
809 355 171 135 762 956 663 28 367 240 641 804 188 614 612 117 85 722 929 517
