20
144 604 488 196 559 124 590 482 176 284 30 404 810 934 858 453 585 785 307 158
445 446 46 706 295 5 576 181 753 921 526 191 291 258 933 126 453 554 944 260
995 474 34 459 590 959 978 553 666 629 569 716 258 299 481 101 692 676 94 598
643 226 647 624 527 368 21 132 783 451 922 872 613 193 480 290 635 1000 386 474
990 940 385 930 217 970 76 781 508 934 685 544 625 127 184 880 395 141 337 971
96 972 69 266 933 688 104 140 496 641 22 306 447 219 740 156 369 364 555 653
710 662 641 986 160 233 517 293 961 526 809 335 880 432 919 599 590 353 378 874
530 681 840 237 579 539 109 100 849 188 626 818 279 217 984 491 348 175 829 856
991 243 325 964 502 884 110 506 330 163 194 935 801 165 59 896 182 493 30 604
741 950 441 215 116 32 702 984 279 439 458 326 546 952 19 673 964 70 773 318
44 770 46 469 954 873 420 440 261 420 95 134 101 656 997 971 347 945 373 557
749 459 728 88 78 841 524 999 538 677 241 574 140 859 847 874 199 375 338 134
826 881 243 515 638 85 13 861 704 875 697 116 757 3 114 125 362 621 950 950
136 914 649 85 543 229 603 216 113 20 982 937 150 641 916 614 802 5 89 666
484 817 123 422 467 789 721 864 759 64 397 525 229 597 989 452 804 304 416 76
444 651 149 950 771 847 329 520 113 898 729 327 526 198 838 686 828 358 302 276
620 270 710 964 498 12 964 892 312 74 781 264 657 411 215 225 184 129 623 307
14 885 745 288 395 125 217 117 856 978 892 480 68 395 308 872 13 316 321 466
970 769 877 373 358 42 421 19 440 965 831 922 463 578 994 425 263 991 923 986
78 139 770 636 653 515 119 956 820 310 578 740 913 839 968 604 3 738 105 90
