20
350 446 960 676 459 653 225 126 511 556 159 706 106 861 70 432 746 221 158 860
603 639 438 557 973 888 160 199 505 25 310 286 17 233 788 482 939 480 419 64
596 463 169 474 190 711 544 283 274 541 262 836 896 950 754 656 835 495 687 624
607 945 729 30 239 388 342 123 905 443 787 330 141 622 892 652 413 575 254 255
786 411 163 606 65 364 765 90 420 396 334 930 283 489 820 951 98 873 912 466
492 856 79 367 601 719 393 219 437 467 477 263 999 662 428 469 804 614 786 246
834 273 69 182 404 497 781 402 752 75 648 807 586 603 817 737 839 385 753 860
904 477 316 827 541 840 318 770 982 392 54 818 626 662 830 497 263 419 154 989
465 362 871 493 270 308 232 485 125 434 370 68 672 221 400 808 431 142 834 413
826 984 22 830 475 24 42 830 293 210 176 10 176 11 26 900 112 590 897 472
636 403 792 875 854 339 142 686 470 108 722 352 436 377 167 599 824 436 660 266
397 185 649 432 548 804 354 439 61 443 349 519 655 855 781 528 898 239 535 993
120 962 929 46 310 258 859 594 189 827 268 860 922 909 727 773 777 318 412 676
986 604 469 110 347 570 497 911 352 304 888 545 582 435 76 261 70 127 12 784
497 608 228 418 309 243 782 560 619 366 117 982 228 669 281 281 766 534 516 384
20 606 223 848 453 633 346 415 300 119 891 88 648 582 482 210 457 834 831 102
704 370 588 158 301 136 198 69 946 589 848 916 247 815 476 593 67 960 904 449
260 43 610 99 8 823 300 252 107 389 107 973 422 350 313 908 961 940 811 193
677 284 21 541 579 543 768 165 187 759 388 778 359 277 421 738 204 403 798 733
999 503 461 80 572 525 556 760 200 793 240 834 563 257 647 682 554 326 915 47
