20
291 190 218 750 393 654 558 463 847 313 579 638 6 286 501 548 586 366 929 527
341 201 771 452 795 907 74 187 583 484 444 325 170 535 370 941 659 998 760 535
47 46 772 237 47 230 699 117 246 457 766 497 246 392 925 932 167 960 922 585
994 656 223 794 368 837 271 300 992 62 977 691 975 718 534 392 62 933 966 881
34 852 389 631 899 68 846 290 150 894 946 200 461 469 167 715 253 964 606 60
527 490 482 754 615 660 9 423 329 570 500 1000 348 883 900 289 667 825 189 965
777 759 390 21 716 333 562 334 507 926 971 958 10 710 584 762 258 994 205 452
55 57 196 307 388 400 350 87 12 415 341 192 233 164 864 830 744 167 834 697
104 249 672 997 604 743 971 655 108 842 345 782 279 160 53 561 282 542 625 795
376 723 486 680 452 122 647 796 356 645 210 393 702 566 201 874 463 45 120 491
819 648 350 267 636 669 746 669 171 319 714 818 392 576 193 421 138 832 586 882
207 804 587 259 678 53 739 319 908 863 517 529 583 518 250 755 386 291 521 587
585 810 275 622 525 497 608 883 473 136 817 486 592 835 132 618 107 251 332 397
723 710 413 293 195 107 664 460 495 962 521 336 935 794 206 615 701 145 597 261
484 937 568 816 952 975 397 336 223 26 64 704 593 10 193 953 602 777 594 624
227 457 327 284 184 841 985 217 331 319 443 255 292 905 106 809 100 88 142 104
320 285 234 744 155 391 289 271 113 721 706 456 719 952 676 475 93 162 762 763
366 54 495 745 306 685 754 836 946 670 143 275 861 339 537 535 624 452 668 472
494 529 35 660 803 902 865 804 192 279 954 507 204 999 34 960 207 262 671 451
516 643 719 958 130 129 751 738 172 102 510 91 36 334 794 765 967 769 901 49
