20
704 650 951 121 926 396 389 978 711 720 893 545 759 422 96 702 701 492 454 791
723 730 157 983 966 567 542 373 315 349 472 403 35 482 391 7 869 267 618 776
424 287 500 572 203 129 235 733 146 817 212 108 701 192 651 579 233 910 463 251
208 145 40 129 234 878 886 409 762 258 193 320 178 382 585 638 519 792 395 243
24 800 469 461 657 200 975 973 572 816 862 716 762 658 469 911 374 364 634 851
972 562 791 139 261 63 700 205 42 846 122 463 938 232 558 665 292 480 900 30
648 342 736 679 93 42 920 988 636 692 960 437 462 369 797 610 996 859 918 734
355 954 483 553 755 340 11 827 51 549 161 272 52 557 391 625 56 43 936 316
786 870 452 796 69 168 770 116 31 970 909 948 977 877 557 696 775 71 362 282
910 453 780 952 305 513 91 744 877 272 263 496 918 856 783 342 330 68 811 888
947 287 820 840 83 542 469 574 500 670 50 266 942 180 69 230 388 450 680 230
196 565 288 670 295 49 56 291 110 855 566 488 581 80 649 217 847 447 199 606
697 256 622 732 43 192 469 721 744 847 416 106 652 697 756 356 824 965 301 242
593 700 253 262 947 3 744 783 831 900 816 806 24 626 249 696 420 107 322 346
838 779 126 46 490 823 201 327 455 295 955 525 656 249 974 527 268 2 856 846
245 572 606 115 947 286 319 270 201 511 390 970 234 834 496 946 73 19 955 708
372 887 851 974 458 810 710 811 486 109 861 852 883 102 678 849 7 984 811 949
556 66 798 718 73 286 761 314 124 919 539 587 586 367 322 297 696 792 278 627
2 814 484 833 37 94 275 112 533 273 867 691 1 522 358 373 379 564 629 608
530 93 906 233 639 120 755 892 180 847 448 614 706 958 691 789 388 102 34 278
