20
753 310 509 200 85 936 854 935 351 111 11 66 659 647 40 986 14 688 784 237
261 22 558 100 400 326 41 790 992 643 257 207 856 734 382 891 516 222 73 539
647 284 827 789 501 386 523 797 259 554 454 665 529 362 286 723 757 99 520 561
617 856 136 229 32 36 152 132 222 977 422 215 174 356 197 528 926 392 391 179
340 70 325 714 399 714 196 716 693 462 737 788 740 863 286 704 411 874 173 669
419 778 468 270 892 927 233 310 361 834 401 824 54 351 202 301 750 964 373 314
105 217 376 957 122 728 760 978 102 917 909 902 57 536 897 634 497 176 289 696
87 459 436 554 430 942 128 441 606 374 422 129 223 208 462 593 275 510 87 284
696 917 750 747 119 890 970 956 95 926 991 282 197 777 467 393 315 454 748 130
532 939 620 681 151 548 687 487 205 547 298 384 496 58 359 947 23 652 521 618
259 563 647 133 502 37 141 588 831 151 399 733 299 987 791 363 944 759 684 57
104 849 304 903 992 766 931 647 13 887 496 77 115 504 288 929 859 212 646 984
609 370 389 980 467 323 445 331 29 684 550 357 972 473 97 302 618 206 723 667
474 520 313 440 204 325 256 96 215 418 21 320 460 44 704 133 513 439 602 506
691 295 606 985 757 128 668 746 65 285 153 386 711 692 647 858 914 895 847 189
248 70 82 703 813 502 24 951 645 496 906 700 622 984 110 44 48 795 528 340
172 446 217 42 984 455 126 66 985 662 240 352 187 655 383 132 785 346 499 531
841 74 501 479 527 751 231 271 852 763 323 942 199 1000 395 358 138 388 592 555
411 233 377 850 137 45 824 464 833 327 316 824 217 407 349 802 757 360 805 132
55 615 476 133 416 759 670 188 778 253 602 386 225 608 148 816 597 772 175 447
