20
892 300 294 735 771 301 665 605 876 89 715 527 97 603 974 482 913 345 989 562
64 506 333 112 636 925 208 985 656 949 373 435 378 599 322 246 34 718 537 543
262 540 29 172 571 548 739 794 385 33 653 106 166 787 397 141 233 452 865 649
229 657 985 286 559 953 307 880 798 466 343 969 89 515 654 714 659 456 202 81
882 186 567 546 284 581 175 140 674 281 722 887 163 36 110 469 172 875 709 800
465 995 890 743 315 889 221 783 652 636 988 500 346 663 964 635 520 580 35 609
167 754 102 467 330 951 60 69 133 310 595 148 63 976 715 632 263 712 756 436
566 482 13 986 262 219 110 725 322 209 164 445 678 27 668 656 509 478 675 611
776 46 383 173 160 555 89 348 45 248 911 275 894 868 740 338 125 310 372 468
307 464 21 282 737 186 704 648 929 912 589 564 905 958 668 102 995 418 310 970
674 874 897 73 826 92 374 892 287 993 834 143 832 999 923 360 938 754 180 973
385 276 382 54 204 81 908 95 372 983 597 603 328 808 146 336 153 249 517 633
537 216 318 149 838 561 293 859 512 85 901 14 902 28 171 842 870 427 348 390
978 629 338 136 930 727 299 54 913 515 297 199 116 657 496 144 317 87 653 916
254 93 734 191 719 765 471 535 913 247 472 186 779 789 919 496 110 507 661 985
397 581 327 232 931 794 656 190 755 253 476 613 408 218 263 150 956 752 676 981
224 534 102 242 300 241 763 768 339 796 449 118 220 119 506 756 650 845 754 418
40 549 884 356 397 50 218 180 372 745 578 47 829 374 465 725 599 980 285 327
320 940 922 787 987 737 544 360 218 155 310 86 857 788 316 472 357 288 695 23
724 733 739 680 783 298 961 637 636 459 14 328 856 788 102 969 622 953 869 223
