20
165 598 317 763 991 363 310 901 457 588 732 959 419 962 91 194 70 801 410 426
822 771 353 524 10 348 108 534 326 661 470 502 26 657 634 987 513 285 626 945
477 420 684 224 426 958 785 994 465 526 348 401 300 565 509 883 108 321 193 483
452 189 589 657 782 798 427 990 612 96 195 288 853 72 415 724 702 252 1 905
108 593 733 21 791 759 379 129 855 897 381 539 183 174 231 647 678 776 53 414
252 662 662 246 62 654 298 64 368 519 679 550 774 839 983 709 900 695 407 847
530 521 381 748 655 332 762 400 284 950 699 34 354 288 405 484 927 865 55 115
119 491 739 144 977 410 500 240 948 623 396 898 334 641 316 575 293 482 686 262
554 878 359 678 706 986 143 847 622 359 4 61 167 415 917 858 174 549 855 812
228 421 406 240 682 413 789 22 51 862 550 222 561 369 266 304 804 772 356 624
77 476 817 304 9 90 461 464 142 208 715 749 95 681 183 985 909 421 43 93
741 965 192 412 784 317 861 745 921 493 362 468 731 53 885 289 570 785 440 80
582 206 887 47 794 303 852 416 877 821 601 440 293 519 636 234 650 744 345 368
768 211 757 6 260 394 88 11 111 161 405 332 454 455 7 658 843 635 821 250
842 965 469 874 405 537 978 865 291 730 536 62 166 462 366 188 855 617 288 658
595 263 202 314 588 111 892 492 257 623 678 889 875 539 367 104 414 18 281 148
688 685 10 4 734 816 165 700 848 438 85 961 235 152 689 676 340 250 346 489
437 961 538 766 473 611 308 204 597 713 421 139 66 142 242 395 264 812 219 640
11 227 194 571 89 240 431 445 285 108 668 167 884 997 823 291 397 135 101 948
397 44 907 752 89 72 117 114 284 394 626 517 192 23 566 17 658 167 496 130
