20
964 577 479 514 428 667 4 161 128 980 855 585 120 73 733 113 989 82 243 427
492 921 292 63 132 353 976 521 197 7 645 940 76 338 591 517 721 180 762 748
620 29 611 409 282 246 291 413 825 880 131 392 733 55 682 206 176 281 821 841
450 658 589 488 313 985 178 513 713 568 222 824 253 397 477 847 212 503 456 538
142 82 227 958 139 485 635 392 335 227 189 430 306 660 826 334 819 203 985 826
239 74 147 311 538 8 400 482 307 66 815 41 691 326 731 694 154 293 422 425
867 291 368 478 786 409 3 623 890 165 143 652 457 843 486 212 674 988 767 8
813 254 515 31 430 1000 555 933 889 161 854 481 570 215 404 996 660 586 677 380
264 625 759 709 973 696 425 420 210 544 613 665 236 173 685 815 468 497 276 467
576 908 332 731 569 596 234 188 469 665 435 283 205 900 198 848 518 884 184 542
373 502 407 664 867 263 133 821 792 904 994 660 747 487 576 678 415 617 507 591
146 544 160 989 851 968 199 894 983 734 960 292 955 584 989 184 295 273 241 977
117 84 570 317 33 981 664 742 51 969 648 801 424 475 494 927 108 373 819 773
555 437 377 451 766 80 62 747 527 926 872 845 789 42 19 778 469 573 60 243
570 472 27 739 871 172 725 767 69 895 942 88 742 367 305 73 314 832 852 90
397 641 927 327 612 872 224 66 210 237 412 555 887 689 636 705 369 520 336 556
972 755 747 664 295 513 545 349 63 34 255 146 745 228 54 744 415 538 185 433
397 220 615 311 381 700 65 957 227 89 335 688 350 141 314 108 928 43 526 552
234 110 600 45 147 767 587 495 54 750 345 101 40 234 283 15 432 155 201 838
683 166 46 811 552 463 323 180 357 715 384 766 464 874 903 148 460 42 714 806
