20
812 605 615 210 23 192 948 541 854 294 922 246 784 964 288 839 1000 71 191 435
742 240 246 981 630 894 540 997 213 770 67 359 619 738 331 499 492 393 552 81
305 222 488 960 158 655 373 733 20 254 865 701 31 176 663 214 556 595 561 373
683 23 8 940 285 182 471 773 530 265 603 130 379 598 422 27 814 728 369 979
893 764 537 279 884 898 869 328 540 669 836 845 618 977 838 911 108 763 13 552
256 780 890 266 280 270 116 257 601 61 610 536 152 453 619 913 35 949 299 925
66 530 333 24 129 851 758 567 853 650 664 143 598 777 751 997 545 700 918 67
786 587 102 615 839 571 313 101 207 687 303 415 933 283 863 610 108 186 452 138
781 491 242 245 659 508 809 911 11 397 133 217 238 819 28 893 114 791 945 239
196 338 150 649 286 620 31 385 591 933 154 483 588 2 844 676 110 783 339 90
379 295 750 548 115 530 528 79 712 136 168 544 303 936 633 407 72 186 45 534
427 8 302 484 341 755 757 206 988 104 234 175 80 317 465 212 608 188 580 356
125 13 408 875 799 298 168 956 902 216 504 878 755 578 829 652 976 230 738 44
816 907 539 890 528 776 435 38 828 288 785 729 179 538 671 177 509 732 746 526
653 113 63 492 158 311 662 296 735 774 353 98 806 11 244 252 679 332 221 239
785 67 512 277 840 996 60 235 340 175 118 396 960 525 385 196 862 500 587 877
585 681 602 41 495 854 952 494 831 455 271 376 785 442 578 726 611 660 617 177
525 929 67 763 705 208 307 760 990 988 649 189 99 739 220 186 787 200 746 278
135 270 505 143 120 371 947 54 351 505 748 915 380 865 575 90 585 118 48 86
722 823 535 300 223 18 153 488 683 295 654 762 802 907 832 250 162 506 812 683
