20
375 328 22 251 362 389 271 401 694 122 147 931 367 897 34 138 479 460 474 979
376 4 501 369 874 74 87 58 3 124 458 255 212 239 147 538 769 88 599 779
275 446 815 232 961 166 861 876 754 347 339 916 58 706 707 566 896 558 293 877
669 270 928 300 958 502 918 208 817 662 756 485 606 652 250 105 162 364 481 880
771 827 536 514 370 413 867 507 55 443 54 288 196 864 840 159 766 482 849 613
848 625 376 256 796 910 697 709 944 100 182 115 80 279 278 939 901 253 31 18
269 934 51 921 70 886 759 841 540 685 600 531 184 93 736 331 54 712 6 928
216 203 18 89 319 119 3 231 99 235 961 807 42 71 120 285 745 41 186 74
424 93 619 768 797 499 727 912 132 177 490 502 643 204 906 958 528 459 327 963
974 449 815 59 777 952 859 596 718 743 928 900 414 700 875 619 527 360 315 25
949 915 954 349 908 322 879 147 458 481 745 312 351 670 942 328 203 520 117 219
187 319 394 492 917 344 818 703 615 86 135 237 628 99 948 515 687 25 41 157
801 718 561 736 733 514 64 147 486 290 10 33 230 205 158 896 706 606 159 620
499 52 6 265 92 221 188 781 572 13 108 201 791 41 410 890 51 942 33 186
956 504 754 259 67 98 840 802 746 712 577 489 74 50 358 55 705 608 890 480
253 283 458 76 190 114 302 620 74 462 352 108 386 113 265 896 900 130 240 167
243 533 463 520 468 106 497 905 645 713 221 868 922 884 508 884 224 799 888 488
816 922 714 572 221 862 282 857 983 543 297 708 466 530 974 720 409 114 40 853
548 970 295 173 155 979 734 859 168 14 347 59 985 446 960 237 507 648 67 952
908 203 174 588 575 56 3 439 519 927 842 649 47 848 815 254 493 867 596 305
