20
822 972 808 243 336 629 878 19 258 427 473 864 611 773 214 900 395 305 974 336
158 711 836 98 373 852 620 654 835 187 984 589 128 726 936 926 178 132 245 76
374 586 768 468 983 500 472 781 599 495 112 996 592 666 108 834 524 62 852 769
396 51 8 125 914 586 722 348 837 830 140 455 812 484 997 981 787 493 23 665
821 187 11 795 942 875 3 647 714 208 970 494 41 577 92 222 121 251 981 179
982 442 715 125 987 5 908 193 340 24 676 246 742 945 651 421 234 339 639 334
827 211 971 234 291 554 12 741 634 780 82 224 285 265 718 860 20 208 191 611
442 827 218 118 291 304 775 693 437 50 33 128 803 879 907 310 73 317 747 97
813 48 467 927 289 553 158 317 327 821 891 866 713 171 999 696 519 37 309 363
935 948 656 865 352 843 427 654 318 788 126 438 976 191 387 251 485 912 904 922
800 98 998 479 948 888 701 267 616 83 888 784 393 390 570 654 244 702 281 141
87 735 897 348 410 67 789 408 280 378 62 304 430 695 168 849 492 722 575 980
252 788 328 110 337 466 815 715 309 754 982 619 556 276 757 667 395 583 733 669
647 814 521 857 323 341 711 557 206 1000 190 461 760 100 100 342 772 664 634 311
844 103 953 200 270 683 723 543 164 126 956 911 6 539 837 4 560 58 15 28
919 852 930 404 865 206 566 637 330 15 680 36 521 226 162 863 570 525 905 986
411 246 81 931 235 530 596 716 29 313 597 836 182 9 369 33 374 995 620 938
589 705 207 519 60 550 529 627 968 122 948 199 261 390 153 177 128 899 417 381
30 790 374 812 737 105 243 5 408 558 151 353 856 844 999 992 665 207 657 863
894 777 858 24 644 426 950 603 552 543 295 853 681 80 130 242 332 267 839 126
