20
771 226 489 346 784 601 747 675 701 270 636 721 927 828 650 783 431 759 476 805
172 415 106 483 605 510 493 10 913 394 974 481 240 722 646 365 431 987 628 538
921 512 915 718 165 278 103 631 777 402 835 247 806 192 800 451 189 99 682 389
973 909 183 18 211 811 373 527 370 699 817 654 44 267 988 726 327 243 672 65
269 894 666 861 403 720 884 465 832 421 995 657 284 208 896 732 812 901 657 756
451 606 499 537 321 271 691 767 958 864 453 929 445 645 473 919 625 412 735 360
727 631 216 36 299 624 477 176 229 139 822 54 671 617 27 674 800 806 45 742
300 63 157 256 501 334 897 254 789 258 410 872 792 488 22 634 143 177 707 260
296 124 513 485 661 342 902 397 908 591 153 995 146 701 795 856 564 245 977 860
913 199 636 148 176 223 265 453 786 310 334 953 236 356 640 116 634 397 543 844
323 391 154 958 170 6 121 910 215 761 881 249 935 882 766 829 566 939 677 391
156 222 915 116 428 42 103 570 959 654 37 299 755 258 286 136 439 155 432 948
898 905 884 781 693 504 619 235 968 960 577 823 695 713 673 957 6 935 592 561
402 986 209 866 12 848 277 265 551 718 535 775 388 612 849 22 43 791 356 376
586 787 82 845 34 449 418 949 602 796 69 163 517 103 496 704 910 318 184 718
127 510 907 577 33 983 853 149 378 20 949 756 969 50 769 175 533 905 947 190
228 279 606 6 574 738 210 655 801 832 973 695 637 157 509 392 748 14 969 205
462 618 479 651 88 710 330 199 117 406 842 891 112 727 888 683 426 846 326 439
939 593 511 902 832 933 328 858 555 776 629 701 746 928 372 820 786 5 820 534
146 698 101 936 38 142 813 551 354 922 333 12 856 586 950 387 322 204 718 320
