20
771 237 193 582 639 732 732 516 927 525 45 865 929 501 373 395 49 315 710 555
401 100 806 978 40 537 473 701 726 134 305 693 744 152 321 265 956 333 317 661
475 91 612 892 922 899 958 316 579 837 744 614 814 573 480 470 867 904 74 394
237 624 136 3 841 238 988 38 809 322 947 939 492 128 708 399 749 609 221 60
779 713 570 289 822 757 965 215 699 839 617 241 484 604 26 851 917 431 742 662
570 525 920 981 337 613 261 505 519 22 928 124 880 789 270 232 303 534 440 602
411 384 999 887 38 327 353 477 629 219 685 227 195 689 626 706 213 150 476 623
163 43 953 887 6 898 813 295 278 515 556 596 829 438 254 984 843 241 933 987
970 467 984 610 1 295 849 780 378 215 321 751 685 446 523 844 776 892 539 376
906 549 816 826 974 822 782 199 401 96 818 941 990 162 877 322 563 427 763 376
45 138 884 30 37 658 944 509 287 650 152 953 256 869 778 586 886 525 771 380
720 225 581 81 715 33 298 245 922 725 13 956 331 460 968 653 55 172 299 292
33 366 11 342 153 83 941 792 499 653 623 661 681 854 191 836 942 423 132 778
662 833 459 978 978 851 796 201 957 72 479 793 863 526 176 66 90 534 393 105
36 182 753 471 187 368 231 736 715 172 213 743 965 455 720 429 604 211 424 33
575 785 778 597 105 19 347 686 989 916 44 819 689 435 960 51 805 389 678 807
655 50 234 738 765 10 903 267 259 243 553 725 24 665 25 989 157 8 203 48
297 509 410 336 798 183 380 137 592 431 417 883 783 951 29 717 100 643 893 24
196 642 686 946 343 369 710 243 350 112 46 505 237 528 910 774 73 785 682 161
313 472 634 995 382 493 718 112 175 872 628 397 416 250 260 228 5 618 842 424
