20
476 295 905 36 657 704 164 916 617 339 861 647 72 923 890 651 941 376 226 994
376 481 327 304 536 594 854 203 163 848 949 645 200 261 849 686 570 903 113 547
536 315 973 903 652 944 372 656 566 153 460 822 421 200 331 920 92 867 668 524
887 923 723 213 909 257 542 106 311 386 951 477 895 791 972 61 259 497 218 52
798 9 888 911 988 895 246 253 486 908 74 816 234 606 485 895 551 116 659 790
879 72 114 139 68 400 38 727 182 809 453 652 96 498 1000 983 958 41 172 788
956 402 269 371 419 344 256 277 151 280 637 953 923 824 942 141 957 471 843 565
141 746 564 117 221 30 180 375 47 981 958 66 746 162 300 144 491 84 339 158
574 839 108 916 897 30 231 564 796 792 729 672 917 151 387 489 567 914 677 432
221 62 657 113 328 776 499 591 636 413 458 348 526 132 537 104 297 479 740 465
909 696 434 706 696 292 3 47 612 604 155 488 506 776 316 369 886 532 269 478
794 955 101 610 999 944 955 406 925 339 167 894 676 686 482 945 33 442 825 943
482 531 429 920 440 904 64 203 750 773 267 79 206 82 328 129 582 185 673 894
37 12 741 54 179 378 782 48 489 20 457 629 48 714 88 159 793 168 842 755
89 135 92 894 374 12 496 88 301 879 497 480 739 324 563 103 617 88 858 412
331 160 290 51 760 863 437 684 940 405 766 474 545 179 701 223 748 583 520 631
257 66 581 158 711 76 393 602 114 150 747 390 93 750 283 184 210 381 524 383
358 155 844 125 456 325 136 416 19 212 304 175 218 287 840 905 929 231 413 754
848 790 521 46 387 886 957 842 150 840 105 874 884 242 248 445 652 580 381 622
293 707 389 147 82 348 145 416 233 412 204 776 766 804 434 39 9 797 338 5
