20
218 302 752 680 647 505 267 153 347 381 572 404 906 774 818 635 444 173 35 510
431 365 39 583 803 28 336 516 913 174 852 278 104 252 361 166 554 496 130 182
920 136 989 248 85 790 176 98 675 691 701 475 411 66 568 384 854 637 817 873
793 282 208 236 615 98 480 911 134 348 963 42 412 385 107 85 221 889 504 231
649 53 960 798 94 18 164 248 436 115 251 61 867 169 69 324 552 410 192 915
607 715 499 357 543 472 211 234 593 660 995 654 913 385 557 818 308 115 999 465
50 8 530 617 701 467 201 579 673 494 124 558 803 897 839 376 229 519 296 824
435 140 174 457 885 462 714 612 931 890 210 684 472 176 370 348 964 773 802 404
294 75 370 355 79 984 59 619 967 84 444 468 512 277 581 357 460 952 772 914
49 138 72 33 168 820 891 179 258 824 878 52 614 864 531 707 647 57 743 708
765 101 928 931 892 808 109 529 280 445 975 259 104 67 541 778 528 246 695 189
955 857 465 550 65 952 324 173 353 978 850 537 847 257 943 614 526 819 281 833
740 662 166 439 589 422 275 629 998 261 440 921 627 612 934 895 140 719 21 418
403 358 541 320 716 718 596 926 331 35 611 201 878 97 720 494 776 816 928 52
129 18 242 651 565 887 819 634 178 652 62 631 149 424 380 553 453 220 34 965
934 571 844 284 754 485 369 240 661 182 945 587 992 233 806 420 311 118 500 816
598 587 193 331 987 756 947 947 424 904 378 704 946 783 895 513 656 157 575 824
452 531 607 1000 847 75 829 17 167 728 579 491 732 234 75 517 957 204 690 476
904 979 413 494 979 262 499 29 867 708 501 987 133 714 495 116 766 171 443 430
275 529 300 325 500 792 281 927 954 843 485 780 874 700 969 946 900 363 689 769
