20
462 896 6 698 7 970 933 53 196 841 37 203 206 895 361 349 739 33 629 597
138 304 285 946 912 619 852 582 806 673 557 191 538 423 771 990 598 344 902 326
166 747 55 260 851 279 468 714 336 67 18 65 271 29 776 853 300 896 261 273
635 393 76 61 520 427 486 606 398 734 829 340 651 946 437 741 438 174 327 136
150 618 191 120 498 14 498 112 499 133 175 203 379 171 922 621 493 447 455 987
7 618 774 242 367 594 575 528 620 821 330 852 101 761 932 390 138 512 43 822
688 211 34 742 566 316 523 665 674 44 299 946 592 692 308 406 332 378 436 825
668 921 923 111 875 234 425 843 409 724 329 463 779 338 688 959 131 639 987 172
464 615 225 590 980 207 532 336 668 810 561 422 874 98 379 498 761 744 674 568
351 985 579 717 884 114 148 677 970 833 921 882 937 336 310 147 711 886 473 551
831 520 887 192 446 952 977 260 864 197 668 810 395 319 393 789 259 600 586 86
430 421 107 67 127 792 482 680 136 32 845 354 224 250 164 391 65 344 794 860
885 514 101 539 118 433 417 83 263 637 639 560 130 210 324 745 851 774 475 289
779 538 835 740 529 265 707 73 930 534 82 903 996 602 849 409 145 862 998 375
57 709 188 433 854 133 269 42 676 997 306 924 900 100 102 814 726 897 186 239
81 806 839 332 407 364 570 50 878 280 393 171 928 580 530 358 717 222 212 599
709 773 546 703 214 847 174 455 363 282 433 311 387 158 841 484 669 573 391 981
979 357 9 167 312 217 114 495 665 817 414 447 636 732 704 164 397 297 545 719
184 63 464 456 280 411 202 879 629 298 62 458 883 516 36 423 437 223 6 709
912 78 142 631 344 930 562 924 257 71 981 245 683 368 144 380 323 390 338 919
