20
573 783 893 365 539 729 968 625 282 985 640 602 108 286 73 307 217 439 643 312
745 501 209 574 639 440 496 87 700 259 315 836 217 808 627 165 227 697 972 353
989 885 940 382 495 738 427 938 283 975 898 170 850 451 41 477 744 537 713 784
353 524 822 814 276 320 332 456 953 276 66 35 141 544 442 270 788 470 433 452
381 882 199 777 280 148 908 585 276 968 247 999 437 882 579 285 820 586 867 755
192 875 453 674 363 881 867 547 623 940 408 334 682 132 337 845 791 972 799 887
323 333 556 200 52 456 333 644 879 970 424 976 477 626 696 444 565 233 613 779
355 530 258 671 739 335 812 36 48 140 112 947 696 11 933 606 285 268 80 28
136 99 479 764 664 133 867 538 141 380 576 651 245 561 851 412 681 234 181 301
474 710 708 65 697 77 906 22 765 806 279 897 982 231 318 752 954 948 414 512
831 864 376 233 880 87 431 849 642 234 248 447 116 276 127 112 336 824 308 746
814 672 337 574 342 436 588 13 46 961 451 128 813 422 781 687 659 728 565 517
379 438 878 70 930 729 974 864 73 90 721 909 708 192 282 441 769 873 255 959
367 978 877 681 655 734 4 480 511 255 733 566 815 150 298 210 638 592 472 429
891 786 440 19 363 528 210 416 100 350 409 532 983 16 325 97 288 700 875 43
261 112 90 73 190 407 734 494 28 985 313 230 858 414 755 1000 20 798 595 543
279 968 455 402 285 47 443 294 811 963 596 838 447 127 699 984 480 824 236 32
275 482 455 712 385 172 533 213 777 243 845 122 928 732 608 773 205 408 449 870
211 684 745 106 420 800 867 263 421 160 403 918 513 968 755 786 874 944 922 90
92 702 187 452 901 36 372 604 796 563 483 208 296 366 735 622 141 783 124 984
