20
619 758 810 137 618 775 322 811 637 894 909 843 969 397 732 423 781 4 654 59
556 803 478 451 711 629 196 45 321 615 624 982 524 554 571 342 506 613 210 837
825 67 810 164 358 894 833 96 485 963 654 105 547 557 382 666 916 389 582 375
984 785 737 875 966 654 967 248 879 996 36 530 678 987 208 775 893 93 451 509
167 98 685 895 801 199 346 110 821 769 213 631 781 1 115 419 171 307 923 812
216 108 919 339 547 188 905 213 847 597 726 688 96 787 53 700 592 899 752 911
174 648 410 428 917 987 850 437 686 294 59 836 320 245 521 291 993 768 616 765
601 151 383 380 530 264 683 930 207 996 703 883 510 693 86 292 906 898 402 267
733 85 668 26 44 920 936 776 247 629 345 520 789 338 605 883 329 696 768 468
446 209 674 293 766 227 674 713 983 207 608 977 284 316 841 503 701 226 448 197
510 672 351 470 361 676 7 315 24 534 422 432 669 900 49 685 421 943 563 262
259 313 214 556 431 561 390 942 768 436 963 581 100 661 26 821 273 904 454 132
111 176 149 555 872 820 625 508 525 820 866 468 372 694 742 436 123 128 389 72
422 154 498 632 67 46 888 349 525 750 280 374 549 969 253 914 968 237 136 121
692 939 582 841 875 594 890 690 245 433 284 604 391 992 802 51 316 985 929 1000
506 566 518 133 239 786 455 393 371 701 216 68 88 90 584 431 854 895 158 710
449 110 324 29 533 562 566 287 655 297 338 274 120 698 402 382 211 417 334 823
944 793 132 874 280 30 228 651 788 260 243 350 377 176 949 2 246 621 157 833
4 501 498 339 26 809 952 579 811 363 122 861 369 178 124 195 742 918 792 999
20 28 546 451 643 894 574 211 774 273 494 539 495 798 634 869 116 238 345 485
