20
725 517 453 602 119 701 782 91 809 625 68 506 985 453 39 270 280 470 180 812
765 31 951 579 114 1000 448 333 264 924 893 338 522 889 529 137 96 244 961 120
885 348 260 5 789 507 673 122 730 671 76 975 904 451 549 363 315 952 198 268
68 914 987 514 76 498 347 110 306 844 844 424 468 830 436 817 298 67 925 592
749 308 557 288 74 643 378 278 366 623 132 851 951 398 893 478 104 636 729 489
674 290 480 11 839 820 855 239 2 281 250 43 733 387 265 260 651 96 874 253
940 517 524 829 675 659 808 69 992 889 68 615 851 967 842 958 27 615 576 375
90 66 83 608 784 35 565 358 144 438 396 387 160 848 185 803 1000 601 326 44
806 586 343 200 984 960 817 907 149 464 183 27 168 988 547 495 936 847 695 151
420 23 389 413 26 722 814 837 50 964 203 529 252 421 632 829 115 858 651 95
263 17 205 701 63 801 651 812 371 33 441 801 13 606 370 41 711 97 856 836
231 948 480 602 64 887 198 637 409 755 85 63 916 202 336 219 865 995 699 439
265 820 931 616 660 95 814 640 110 943 117 187 668 413 863 207 421 250 586 183
639 647 235 263 411 731 162 11 275 648 153 53 288 216 32 344 714 612 45 536
16 4 113 323 960 244 177 224 515 27 459 168 193 179 857 394 963 437 843 49
301 907 722 867 17 597 323 438 639 738 888 708 795 715 46 111 308 771 2 817
252 949 844 70 916 439 414 2 354 620 203 542 939 557 47 547 495 843 112 560
436 527 361 747 734 847 897 944 893 819 249 208 274 465 653 527 797 683 644 327
495 726 48 555 741 822 455 311 481 192 441 828 245 100 877 545 57 836 771 615
640 949 827 316 823 33 482 421 421 558 194 342 564 578 965 179 131 458 155 41
