20
254 531 658 238 769 995 273 565 729 193 930 889 368 44 361 453 663 42 901 167
507 114 172 886 836 598 731 434 486 444 789 376 801 124 477 434 378 918 847 173
297 961 937 935 591 400 468 366 343 94 334 213 58 5 931 546 43 5 33 550
156 810 824 885 4 21 343 519 245 814 287 798 462 678 35 132 920 784 392 993
780 689 141 660 135 762 366 617 516 602 657 551 994 577 148 791 107 682 69 825
668 145 153 759 650 58 525 669 492 893 650 37 507 754 738 636 885 31 996 294
394 544 72 510 256 429 462 493 500 646 561 740 467 597 252 290 760 891 769 886
940 864 676 454 526 81 306 381 791 833 810 699 728 871 908 749 632 808 402 114
535 350 205 753 955 170 714 147 255 358 595 746 864 845 67 223 913 506 378 315
22 489 956 803 930 459 55 913 489 546 762 73 670 115 236 958 460 905 120 566
34 663 581 889 71 56 681 143 326 976 59 332 354 860 304 648 107 806 492 463
939 623 999 883 315 718 127 554 182 156 133 975 645 210 715 6 575 776 370 591
105 552 318 624 237 240 848 475 315 444 662 1000 112 988 700 560 106 155 361 681
251 331 151 559 558 896 291 297 21 533 412 315 506 804 172 679 79 795 523 819
821 672 228 251 190 716 459 632 436 787 401 261 693 465 947 740 464 908 524 808
134 356 945 914 894 450 326 422 889 43 377 119 571 721 843 64 127 897 928 350
892 220 440 264 862 457 364 371 70 49 99 100 232 357 168 279 117 537 413 172
748 678 813 959 172 2 96 44 97 824 216 17 274 158 244 945 484 542 268 757
714 282 129 87 539 730 631 973 448 276 961 603 373 602 32 191 539 366 270 262
210 131 205 899 380 242 652 455 4 404 94 934 831 602 330 502 155 568 944 717
