20
262 89 41 566 53 322 899 157 296 723 799 65 439 493 161 897 165 144 439 910
106 884 708 314 837 156 21 93 198 838 802 196 315 514 455 781 721 973 866 281
384 803 132 12 70 900 5 307 174 143 227 780 809 686 248 206 476 51 468 466
333 786 449 546 393 36 156 65 595 136 191 750 464 119 360 671 400 121 48 571
235 219 880 579 626 277 286 108 846 776 433 569 120 356 471 418 569 678 795 883
167 538 175 692 324 662 114 926 71 567 862 211 640 377 767 104 792 351 529 598
438 525 181 725 923 888 964 691 784 490 925 269 685 941 590 325 269 518 128 183
698 267 500 131 955 425 294 844 265 538 252 216 6 175 140 779 863 397 93 34
458 745 778 253 553 430 600 168 18 941 500 922 137 952 550 14 684 666 61 914
549 927 104 32 419 39 558 431 285 146 954 684 225 70 875 803 856 455 26 780
507 678 91 747 531 108 568 450 620 397 557 850 602 685 822 186 81 440 385 861
867 619 684 945 663 120 206 741 787 336 897 336 136 761 458 783 834 600 653 17
691 808 682 373 662 671 493 286 93 852 457 16 57 636 828 773 279 432 986 498
639 384 767 93 165 291 925 866 20 927 160 193 961 828 416 823 319 820 572 778
571 218 168 826 580 991 479 514 277 550 329 251 426 679 520 545 282 857 819 161
591 345 466 615 34 694 41 805 69 359 887 183 951 289 112 635 99 485 123 112
431 279 341 836 508 762 830 64 405 369 913 354 887 849 668 959 806 107 569 831
653 428 419 606 691 807 997 550 483 15 19 139 565 381 59 324 164 79 188 491
451 52 83 249 603 105 778 102 140 548 870 925 91 534 476 910 110 848 967 239
657 303 717 65 555 167 367 661 375 742 663 687 993 211 381 892 150 310 984 659
