20
810 341 18 28 385 633 667 37 802 228 216 121 335 122 661 201 451 770 169 253
962 858 80 682 360 393 566 833 829 69 938 762 582 796 439 291 19 162 938 100
239 308 665 174 476 769 653 899 522 511 775 597 701 325 907 41 890 368 585 52
694 903 417 949 216 513 511 59 559 69 24 390 282 363 714 477 414 998 797 128
273 36 651 142 736 376 82 281 676 701 599 592 141 555 28 441 707 715 418 88
644 126 652 663 315 844 857 151 182 707 42 878 427 844 822 324 51 979 824 718
628 993 467 924 459 468 112 733 933 802 934 206 275 92 405 347 944 31 583 729
932 343 731 527 93 101 215 166 346 493 74 988 676 257 149 867 268 216 727 59
873 570 264 361 511 570 30 302 953 845 266 304 349 193 457 684 438 269 931 574
112 983 4 843 350 634 200 515 924 15 5 625 702 405 61 700 971 951 28 306
329 957 980 99 749 638 767 723 38 125 256 539 741 778 885 775 686 570 98 970
563 63 593 808 170 883 873 590 190 224 374 85 921 263 75 710 893 632 553 194
956 428 25 953 356 263 281 101 816 24 392 827 476 238 330 750 673 596 390 725
933 594 709 132 947 272 926 191 875 866 471 853 197 130 181 265 899 255 692 308
781 185 773 767 383 206 851 323 678 598 134 679 240 314 810 296 379 304 796 243
927 978 284 280 632 893 422 546 796 60 879 992 776 268 604 642 729 126 622 998
603 11 753 943 77 803 574 615 981 642 2 704 218 602 930 828 357 60 144 412
326 402 405 823 810 953 186 420 843 489 357 295 440 693 825 966 915 219 216 789
837 844 760 164 103 176 165 781 537 718 416 740 860 807 352 226 85 487 566 458
248 168 219 473 138 837 749 515 866 610 579 391 115 535 200 15 299 560 128 284
