20
925 258 632 613 293 438 170 590 262 378 877 615 687 826 398 473 855 193 414 402
518 424 896 357 678 496 930 251 971 509 427 325 473 605 320 770 968 836 610 110
385 424 708 402 432 170 356 882 244 71 255 731 834 184 805 100 577 48 595 419
194 572 436 274 141 213 834 465 627 712 936 681 396 996 590 442 229 801 237 851
349 751 196 35 48 689 57 124 153 946 467 472 462 111 445 158 705 191 14 637
580 718 473 661 109 423 717 594 18 341 842 919 256 737 458 932 785 783 749 453
25 667 552 492 155 429 448 55 961 952 893 369 270 304 817 83 819 181 309 170
633 952 712 751 887 425 824 829 52 618 25 152 738 450 997 981 273 384 304 826
366 64 327 769 882 71 15 792 973 533 39 656 95 559 542 253 403 891 965 616
610 409 196 596 477 554 911 610 338 888 791 918 201 802 76 563 551 429 728 666
875 382 601 956 930 753 852 301 471 873 77 390 853 645 11 763 154 206 491 622
814 718 220 1 621 877 212 363 911 439 134 116 646 860 400 565 199 430 29 245
548 554 133 435 12 603 179 513 719 932 796 951 86 842 448 111 323 451 761 507
818 258 215 932 548 599 227 623 626 484 109 12 888 769 98 704 891 139 644 482
577 161 404 233 203 182 452 850 709 100 246 849 775 912 151 19 527 146 660 751
61 372 993 874 756 355 622 596 83 157 184 305 207 179 67 766 961 483 490 936
310 275 479 536 77 536 990 739 379 160 864 40 389 346 984 798 857 992 243 244
699 889 598 1 41 354 778 756 34 842 272 410 6 971 648 539 328 115 953 938
4 704 459 845 127 502 121 646 77 647 687 239 33 983 72 313 589 931 361 772
738 446 301 31 252 172 601 899 582 64 501 750 892 59 33 707 698 684 727 731
