20
684 898 493 557 837 68 602 968 647 380 428 395 61 383 819 629 741 501 150 781
63 50 639 841 699 37 832 122 544 581 545 400 37 492 919 555 792 794 885 630
575 832 336 356 339 590 170 977 138 222 915 916 218 827 11 671 952 237 490 830
45 65 243 931 720 813 130 578 412 505 311 391 716 620 185 487 489 17 961 972
205 456 728 211 214 807 769 507 935 621 355 476 957 94 267 621 696 846 999 469
264 192 18 625 752 958 852 926 592 987 485 921 862 862 422 188 793 348 825 571
618 946 745 649 496 671 923 429 314 385 424 346 545 311 995 314 314 451 173 435
667 451 304 62 400 803 882 98 858 620 910 82 685 991 394 698 694 647 77 400
529 378 454 564 316 959 497 511 68 797 356 340 532 134 805 628 720 591 264 203
666 838 987 459 717 828 612 323 647 477 912 267 808 810 655 568 249 918 235 791
728 797 734 711 420 589 762 36 392 410 454 695 609 187 432 79 787 151 865 853
523 897 583 717 327 848 780 127 741 169 598 760 115 35 556 901 436 975 754 102
481 412 74 382 850 45 806 781 580 351 472 571 844 210 353 537 241 334 431 614
535 268 874 826 528 172 886 984 654 138 424 17 630 276 661 384 908 400 894 793
346 178 266 794 610 949 602 503 884 531 339 971 901 197 698 978 87 66 86 877
175 731 656 839 509 358 865 885 815 170 145 753 613 63 696 33 311 536 484 864
243 762 155 536 120 174 63 28 133 930 120 672 823 399 156 838 220 232 450 537
644 356 385 970 293 718 301 816 181 657 540 192 232 769 828 955 410 817 317 974
735 435 377 223 620 71 712 272 67 537 829 952 438 548 465 673 126 809 153 931
410 99 429 924 815 265 410 83 570 152 465 648 766 527 413 619 779 568 481 591
