20
276 820 908 375 663 581 443 497 739 216 698 209 558 637 741 737 591 746 728 780
459 606 896 31 989 922 234 305 366 540 136 967 82 611 944 993 741 983 948 48
616 371 362 868 100 210 105 427 475 303 821 466 734 819 732 130 335 374 186 145
125 839 971 870 74 531 615 154 123 182 284 354 604 927 418 636 396 338 509 918
455 179 359 453 414 876 440 768 779 643 727 831 890 694 502 528 735 608 166 875
300 677 93 982 327 87 207 186 983 430 212 397 970 324 502 539 214 23 519 162
225 226 786 273 205 884 306 133 513 929 47 308 285 382 122 907 335 288 875 630
211 762 359 210 478 334 714 79 319 516 889 356 598 537 985 957 71 51 534 654
400 706 196 117 573 311 175 784 800 631 813 830 482 342 988 889 578 301 179 229
678 573 637 658 401 325 631 706 552 491 501 153 12 301 619 576 201 597 648 268
447 545 892 823 974 510 861 784 970 319 533 80 181 321 120 166 718 423 361 16
785 283 600 479 893 823 46 961 93 343 348 222 230 857 178 211 284 143 637 328
366 290 829 131 590 413 336 784 114 322 474 937 247 764 537 321 756 252 762 268
747 633 983 238 5 662 487 2 277 938 443 209 92 223 130 821 789 60 886 699
143 916 929 328 843 163 726 985 470 452 320 29 36 419 182 752 456 248 101 632
656 3 152 716 555 381 919 339 814 283 907 532 19 589 277 692 970 622 944 717
942 154 400 192 481 408 380 132 468 817 505 949 523 982 451 105 567 941 134 385
762 111 784 495 40 374 563 868 308 970 578 915 788 133 938 206 457 561 37 110
240 196 756 232 443 115 570 684 996 571 818 306 734 203 730 543 253 658 744 265
353 739 48 393 508 794 403 41 3 225 661 73 467 559 283 526 480 276 355 468
