20
870 236 970 997 404 977 752 775 181 469 253 143 327 956 884 646 638 651 66 975
730 919 146 669 65 137 964 402 587 820 282 28 858 437 423 335 803 153 73 362
763 125 603 928 509 809 125 652 272 356 138 509 372 663 347 636 662 920 59 234
218 299 536 231 148 743 614 192 67 141 69 981 52 244 508 560 793 306 519 313
33 992 38 96 833 640 726 888 417 883 602 344 405 92 838 605 31 553 613 522
813 891 590 396 572 649 521 347 502 80 78 607 237 742 305 265 421 534 937 587
352 856 528 476 166 319 485 74 183 314 564 488 153 434 183 655 694 674 817 269
996 914 212 715 590 94 28 237 960 93 758 507 40 302 342 98 383 902 200 314
188 885 738 212 184 393 940 854 662 281 7 938 541 149 22 691 121 87 100 78
256 392 356 591 734 391 454 791 965 831 65 413 400 660 852 202 872 64 154 298
76 984 167 271 634 570 970 513 927 849 560 243 139 321 919 447 686 416 299 232
735 727 593 816 680 427 198 917 400 104 985 903 220 490 601 853 129 189 686 246
121 373 606 608 243 743 902 942 122 184 412 609 480 628 416 997 184 245 205 731
864 740 574 301 282 906 382 551 224 766 26 187 940 329 399 872 66 895 828 644
210 87 920 829 368 466 407 563 701 10 353 30 576 655 841 590 872 39 263 798
607 408 687 655 706 320 383 911 638 143 371 517 615 931 15 568 30 379 518 489
864 72 867 799 677 930 691 736 98 563 213 254 735 241 531 644 161 356 454 148
952 86 400 507 307 568 943 404 585 89 400 647 822 969 398 562 935 247 917 860
583 239 898 363 304 196 548 575 18 36 580 892 714 765 658 447 779 399 425 328
272 17 830 237 431 691 941 919 175 257 223 361 324 806 577 608 995 498 831 7
