20
482 352 779 594 673 842 105 906 443 234 49 793 519 208 667 965 211 806 477 831
266 46 582 285 356 104 57 961 312 710 488 649 561 397 513 144 953 277 34 61
497 792 372 749 266 244 569 508 311 521 896 592 702 186 465 537 701 185 379 392
518 626 130 252 342 455 808 298 253 947 633 69 823 139 153 75 34 31 359 152
169 788 731 895 937 535 20 634 140 693 484 505 814 484 662 20 958 277 552 489
546 49 524 371 555 93 266 724 308 177 212 238 147 787 629 749 249 43 477 408
178 194 511 667 963 674 726 552 914 636 205 217 129 333 253 880 402 717 652 535
843 600 39 281 704 377 967 208 682 716 112 795 282 347 480 950 669 970 738 599
350 667 320 945 416 262 254 676 435 53 276 728 980 99 920 937 129 459 208 985
428 105 970 443 385 9 850 975 291 458 470 67 825 524 455 374 208 283 404 350
849 902 657 144 406 657 442 612 585 134 450 849 997 634 177 923 933 90 800 269
630 666 513 771 672 608 155 744 862 235 758 217 268 613 435 839 948 45 305 313
270 215 565 839 563 716 660 610 120 162 534 353 378 946 845 681 199 936 950 604
439 58 908 483 425 19 191 549 902 650 55 537 258 353 745 889 287 108 202 29
33 736 739 230 954 736 793 742 564 178 470 969 979 847 962 500 794 860 407 435
671 912 485 965 176 993 395 794 629 777 158 247 773 402 32 138 902 967 94 970
858 1 378 834 917 216 48 166 798 18 42 85 663 80 322 231 575 409 521 599
629 672 112 533 934 1 53 171 996 609 600 603 675 631 784 466 51 713 153 946
726 272 190 755 384 256 443 594 523 769 190 286 944 165 52 530 637 622 324 928
764 505 868 609 415 83 712 360 79 613 738 192 630 876 192 598 71 765 881 716
