20
567 846 670 127 564 388 394 83 366 225 917 852 70 442 785 1 190 166 740 927
206 712 835 967 455 710 844 16 788 927 966 30 898 358 107 857 489 277 480 463
796 463 457 840 185 797 602 477 73 51 551 133 255 566 180 138 115 381 160 740
581 440 417 905 363 787 808 87 811 729 351 258 473 521 70 679 78 936 206 637
721 816 591 552 681 813 23 267 977 49 578 257 276 282 588 898 223 795 767 76
919 18 963 273 120 341 813 151 855 969 65 318 77 316 170 548 248 256 986 944
327 775 152 226 215 108 441 25 301 329 430 479 670 646 235 982 717 441 227 621
596 793 160 815 425 485 30 917 990 141 726 322 910 829 378 337 996 816 482 547
315 708 71 556 90 563 873 313 794 187 821 471 302 106 54 250 864 417 123 241
513 610 478 487 251 327 400 7 423 143 198 221 153 372 108 240 187 438 153 676
596 198 639 775 790 926 395 378 47 817 663 797 422 66 220 316 57 110 751 626
144 857 981 192 879 620 897 668 654 734 684 741 688 691 709 146 255 837 739 443
137 88 578 625 268 306 317 336 635 799 462 472 18 993 49 515 620 672 63 695
2 572 957 587 349 894 411 445 920 91 873 667 2 784 702 903 201 158 823 161
741 367 61 556 598 496 21 993 521 460 553 642 89 58 756 75 111 926 247 814
693 666 241 512 901 968 372 443 960 352 732 213 838 560 206 711 585 819 479 394
812 197 566 555 285 382 590 331 403 943 213 512 714 878 579 174 369 447 787 727
124 41 430 98 48 181 419 67 601 552 99 868 192 299 322 473 258 996 624 426
232 872 152 443 171 669 749 532 611 380 436 341 892 608 472 150 968 156 38 705
808 419 417 970 239 35 541 793 3 974 679 239 145 328 557 198 706 11 510 519
