20
336 238 732 224 939 25 141 912 616 615 486 336 66 413 834 5 162 698 967 487
313 792 896 626 392 954 105 183 351 711 751 418 937 229 685 554 961 101 700 507
984 333 546 605 827 860 590 419 523 626 72 399 876 238 651 893 425 565 556 92
599 961 439 820 319 145 388 501 105 922 318 260 879 788 707 182 923 865 711 988
713 516 244 552 729 475 112 652 145 221 440 357 352 160 129 804 95 7 121 972
692 439 1000 944 853 796 683 957 404 995 911 170 341 157 78 893 473 886 957 317
116 718 814 742 549 725 346 147 708 924 349 290 270 12 448 667 130 332 683 636
311 164 64 222 293 596 454 144 570 637 289 942 298 103 246 862 560 696 500 388
275 66 31 330 558 819 178 286 719 980 574 302 281 499 835 711 242 191 663 37
984 314 448 139 957 77 418 310 799 368 270 811 850 210 92 205 103 442 787 68
592 438 734 453 9 51 741 579 902 116 614 845 817 373 470 138 878 877 559 274
646 618 919 644 62 408 259 538 757 73 942 350 895 20 89 358 426 270 787 374
805 110 71 233 817 426 116 976 87 999 618 13 924 181 502 265 551 998 253 877
831 608 194 543 486 961 451 724 80 927 541 342 9 422 731 508 692 543 320 223
690 550 738 516 222 737 368 475 410 445 311 381 952 849 582 864 304 967 717 617
304 486 39 850 441 735 282 964 182 772 544 488 694 789 33 24 850 635 946 654
209 886 563 854 476 374 907 155 568 742 532 810 504 437 209 336 887 111 258 946
966 258 815 841 540 785 664 1000 836 799 589 332 720 29 518 638 672 923 447 687
93 272 727 729 52 318 177 439 42 362 530 931 729 289 524 121 58 456 417 676
737 5 777 493 752 414 432 753 948 380 389 390 774 671 315 532 969 627 258 444
