20
940 535 189 304 934 235 551 402 986 464 935 145 57 672 706 956 466 145 174 734
193 1000 87 944 207 893 913 153 697 162 412 103 774 776 773 106 424 964 109 46
903 668 958 882 67 640 39 192 523 168 230 434 580 728 109 659 612 510 210 211
109 769 97 840 702 787 379 816 200 473 769 727 771 756 79 100 478 662 400 612
445 425 966 232 115 376 496 103 384 964 164 391 955 838 549 289 574 774 781 471
699 726 655 812 260 988 523 434 306 268 626 382 552 15 72 591 683 97 599 140
966 141 694 898 658 10 511 806 28 444 52 791 34 777 708 705 509 602 878 927
928 99 439 761 759 734 329 676 856 861 444 829 91 834 130 792 626 663 938 309
178 918 608 108 815 857 534 408 571 881 439 471 811 431 491 562 307 308 222 564
869 459 376 664 829 865 584 687 85 197 143 575 77 786 933 730 55 60 418 853
242 864 30 465 434 442 18 538 48 387 864 341 251 657 881 375 53 983 38 492
551 389 615 606 879 543 935 549 65 321 306 255 810 157 642 227 50 343 732 813
803 345 315 888 975 342 426 472 546 903 965 95 809 325 213 983 424 143 770 16
74 361 420 573 999 134 482 765 612 968 476 312 864 474 994 787 167 476 825 506
724 263 994 65 639 66 512 630 624 17 967 320 785 625 324 858 304 365 312 909
251 142 556 753 286 362 844 679 69 543 338 731 825 555 157 752 323 506 386 616
754 528 351 837 936 406 609 348 79 829 361 851 505 942 794 310 797 193 985 787
427 332 589 205 811 315 62 650 17 742 686 367 239 855 567 50 46 744 867 179
880 869 916 821 736 782 145 684 955 765 364 438 194 774 900 885 292 95 678 616
242 437 385 359 422 112 975 969 702 94 872 703 567 870 912 157 77 198 278 242
