20
95 649 76 145 326 780 761 278 586 731 514 9 428 607 74 255 945 557 707 884
450 56 710 74 132 674 511 795 19 174 397 682 319 955 719 433 27 314 916 251
490 315 296 412 960 381 272 27 491 450 677 822 105 118 805 761 879 605 902 772
1 222 512 96 451 999 556 231 717 658 881 883 841 722 475 875 644 267 270 663
852 190 331 56 514 394 342 318 456 378 982 737 901 226 715 962 959 537 898 390
273 786 183 110 386 434 596 419 585 621 419 751 722 227 238 250 881 279 483 692
850 243 962 61 629 472 713 105 287 40 370 663 417 649 99 900 784 832 102 960
95 51 916 916 53 894 128 326 6 93 237 147 794 348 64 721 587 965 166 184
567 590 996 433 251 812 456 795 403 472 430 403 344 239 810 811 32 199 685 178
423 873 448 904 285 303 802 861 557 467 5 373 383 924 813 779 581 413 664 879
627 843 632 452 66 93 328 836 719 679 765 274 99 343 140 702 298 547 516 165
59 612 994 413 622 183 394 1 647 542 497 650 460 562 308 865 96 108 624 71
173 408 916 624 771 774 535 87 447 826 140 548 61 800 557 468 486 664 498 666
793 659 862 494 19 923 667 986 931 395 78 558 335 65 631 873 677 765 204 453
8 857 834 483 599 144 947 17 777 933 237 576 583 299 596 663 287 647 41 667
645 128 921 40 776 707 730 946 276 527 516 479 159 450 894 605 916 167 910 499
755 431 903 690 458 302 542 45 862 355 269 935 925 519 298 835 911 145 581 191
648 668 258 411 42 637 518 97 663 601 467 367 393 719 367 797 183 994 723 850
182 601 165 620 987 359 973 287 549 800 92 27 967 51 44 705 48 971 95 899
963 912 310 397 603 49 41 562 239 65 369 941 94 210 9 56 594 535 847 800
