20
890 902 321 392 889 486 908 964 998 755 836 122 924 802 984 81 172 159 381 730
995 10 43 331 514 921 576 479 812 81 332 552 444 264 236 122 423 770 370 605
463 684 659 405 303 443 781 980 591 64 27 216 8 40 657 34 736 425 858 209
447 307 221 161 495 912 173 739 653 328 531 364 180 411 376 117 197 415 385 590
303 771 944 762 17 381 698 715 87 763 897 83 538 452 294 522 319 211 812 607
279 767 484 247 48 936 853 887 376 997 562 473 451 442 184 342 443 196 129 283
232 839 388 684 33 827 103 655 442 856 105 345 692 429 571 799 501 186 327 719
9 604 682 481 722 252 729 811 298 31 449 556 137 652 563 483 226 270 873 57
400 675 952 735 588 471 350 26 895 897 278 606 463 266 47 103 699 276 510 483
122 798 454 164 457 247 841 609 738 315 391 646 653 204 267 795 989 11 366 250
726 627 469 353 904 327 81 880 271 274 699 950 615 957 753 840 953 589 996 919
871 233 271 509 931 20 70 584 843 631 714 940 430 213 590 870 284 21 748 81
462 83 608 218 14 280 700 886 590 382 27 153 725 961 243 926 846 963 897 532
928 5 673 967 662 189 937 294 925 262 637 336 936 478 167 421 549 990 977 552
761 802 713 602 918 789 389 365 337 788 16 400 418 301 52 446 919 322 415 898
779 559 111 809 459 918 46 687 688 504 701 894 969 223 547 381 738 923 387 644
86 889 965 719 714 994 768 211 967 212 241 551 251 892 284 579 308 146 77 126
852 335 19 63 210 548 128 660 867 222 277 360 363 12 781 218 365 663 688 98
519 30 698 380 366 550 154 191 314 747 820 665 909 306 591 347 854 111 10 471
747 196 433 356 985 83 782 77 250 713 778 965 917 261 875 379 731 465 883 808
