20
902 494 425 930 982 366 721 630 2 986 17 113 873 333 837 960 677 869 30 482
851 996 229 688 841 188 984 876 71 922 465 979 312 239 602 609 357 22 647 81
874 419 49 764 356 710 183 330 135 876 844 503 952 693 492 20 264 752 645 590
692 671 705 584 982 184 139 220 160 780 731 252 214 785 949 453 799 733 971 429
120 391 603 967 887 372 253 313 257 176 751 230 14 860 586 371 365 291 744 29
410 382 84 640 907 121 775 66 271 189 865 5 214 557 846 683 904 796 2 757
173 679 170 160 419 97 868 621 26 739 251 92 22 783 723 600 852 694 454 185
59 475 736 116 132 150 694 896 586 235 755 510 130 329 979 618 972 108 355 996
741 661 939 731 981 839 664 203 22 434 952 871 442 536 736 825 471 780 309 51
281 719 270 475 429 408 606 948 694 16 781 683 682 667 676 671 285 324 47 374
4 928 243 30 32 980 977 548 982 521 870 360 765 27 886 280 18 766 545 260
178 841 285 919 255 378 752 1000 845 705 119 933 89 557 71 949 790 961 284 886
791 156 601 949 887 938 371 698 17 491 578 464 290 827 102 145 65 361 974 650
34 473 409 635 476 988 155 983 243 468 650 739 797 949 381 303 606 715 620 105
874 99 575 760 944 365 658 385 142 562 800 164 551 21 654 736 38 93 49 310
151 284 964 795 308 712 305 178 808 488 464 406 319 628 774 494 412 329 722 363
452 142 34 960 217 224 987 713 570 625 619 660 840 301 546 815 543 996 399 529
544 804 765 722 629 886 874 8 803 612 799 714 296 906 881 805 213 290 78 823
921 715 943 958 64 317 528 761 76 59 839 496 933 278 506 730 42 963 652 239
161 367 484 574 337 477 178 11 614 944 826 81 387 653 92 851 22 177 296 631
