20
569 496 790 308 210 889 900 805 97 958 604 486 47 693 307 958 72 569 821 664
797 399 683 267 424 922 400 610 19 739 47 607 835 264 249 130 172 217 440 265
525 101 676 975 121 924 99 698 546 688 305 477 726 396 777 307 921 609 816 773
906 908 882 784 594 418 237 806 129 908 751 586 69 902 884 535 499 56 154 459
262 622 100 462 404 382 773 97 645 87 843 96 211 882 261 360 413 552 684 881
405 723 50 804 221 339 340 391 299 855 764 926 592 781 823 577 678 341 171 606
4 176 151 641 556 330 435 471 583 448 725 687 885 404 478 819 215 654 813 839
866 308 664 805 864 930 562 451 683 260 795 339 143 719 152 936 787 150 199 661
174 642 552 410 864 571 162 333 414 362 664 38 615 703 334 192 322 955 589 932
131 213 342 962 147 220 229 774 484 687 422 518 806 952 690 269 888 765 32 596
310 561 586 585 735 65 572 11 975 870 11 201 728 586 96 220 899 240 378 32
193 901 272 66 826 262 956 261 227 210 512 554 283 482 270 830 265 111 97 831
540 557 667 185 83 953 211 630 833 923 743 967 440 510 832 92 877 985 470 909
959 772 495 841 989 59 588 65 259 524 172 361 296 777 169 924 128 343 195 157
315 321 814 309 70 538 434 479 611 189 226 13 1 108 632 90 460 973 297 604
154 975 869 118 332 562 65 370 912 477 984 49 632 957 57 136 140 530 600 357
19 380 406 360 427 910 280 531 319 943 56 357 1 638 75 653 457 376 777 337
90 876 651 705 514 620 770 327 10 651 408 392 241 770 434 991 94 872 66 720
399 308 495 749 766 94 939 356 527 428 290 577 152 279 448 890 799 392 735 620
881 97 175 473 482 289 156 405 814 144 965 697 984 193 24 943 837 839 714 225
